Symbol	Description
AAB.TO	Aberdeen International Inc
AAV.TO	Advantage Oil & Gas Ltd
ABST.TO	Absolute Software Corp
ABX.TO	Barrick Gold Corp
AC.TO	Air Canada
ACB.TO	Aurora Cannabis Inc
ACB.WT.U.TO	Aurora Cannabis Inc Wts USD
ACD.TO	Accord Financial
ACD.DB.TO	Accord Financial Corp 7.00 Pct Debs
ACO.X.TO	Atco Ltd Cl.I NV
ACO.Y.TO	Atco Ltd Cl II
ACQ.TO	Autocanada Inc
ACZ.TO	Middlefield American Core Dividend ETF
AD.DB.TO	Alaris Royalty Corp 5.50 Pct Debs
AD.UN.TO	Alaris Equity Partners Income Trust
ADN.TO	Acadian Timber Corp
ADW.A.TO	Andrew Peller Limited Cl.A
ADW.B.TO	Andrew Peller Limited Cl.B
AEG.TO	Aegis Brands Inc
AEM.TO	Agnico Eagle Mines Limited
AEZS.TO	Aeterna Zentaris Inc
AFN.TO	Ag Growth International Inc
AFN.DB.D.TO	Ag Growth Intl Inc 4.85 Pct Debs
AFN.DB.E.TO	Ag Growth Intl Inc 4.50 Pct Debs
AFN.DB.F.TO	Ag Growth Intl Inc 5.4 Pct Debs
AFN.DB.G.TO	Ag Growth Intl Inc 5.25 Pct Debs
AFN.DB.H.TO	Ag Growth Intl Inc 5.25 Pct Debs
AGF.B.TO	AGF Management Ltd Cl.B NV
AGI.TO	Alamos Gold Inc Cls A
AH.TO	Aleafia Health Inc
AH.DB.TO	Aleafia Health Inc 8.50 Pct Debs
AH.WT.TO	Aleafia Health Inc Wts
AH.WT.A.TO	Aleafia Health Inc Wts A
AHC.TO	Apollo Healthcare Corp.
AHC.WT.TO	Apollo Healthcare Corp Wts
AI.TO	Atrium Mortgage Investment Corp
AI.DB.B.TO	Atrium Mortgage Inv Corp 5.50 Pct Debs
AI.DB.C.TO	Atrium Mortgage Inv Corp 5.30 Pct Debs
AI.DB.D.TO	Atrium Mortgage Inv Corp 5.50 Pct Debs
AI.DB.E.TO	Atrium Mortgage Inv Corp 5.60 Pct Debs
AIF.TO	Altus Group Limited
AII.TO	Almonty Industries Inc
AIM.TO	Aimia Inc
AIM.PR.A.TO	Aimia Inc Pref Ser 1
AIM.PR.C.TO	Aimia Inc Pref Ser 3
AJX.TO	Agjunction Inc
AKT.A.TO	Akita Drilling Ltd Cl.A NV
AKT.B.TO	Akita Cl B
AKU.TO	Akumin Inc
ALA.TO	Altagas Ltd
ALA.PR.A.TO	Altagas Ltd Pref A
ALA.PR.B.TO	Altagas Ltd Pref Ser B
ALA.PR.E.TO	Altagas Ltd Pref Ser E
ALA.PR.G.TO	Altagas Ltd Pref G
ALA.PR.H.TO	Altagas Ltd Pref H
ALA.PR.I.TO	Altagas Ltd Pref Ser I
ALA.PR.K.TO	Altagas Ltd Pref Ser K
ALA.PR.U.TO	Altagas Ltd Pref Ser C
ALB.TO	Allbanc Split Banc Corp II
ALB.PR.C.TO	Allbanc Split Corp II Pref Ser 2
ALC.TO	Algoma Central
ALC.DB.A.TO	Algoma Central Corp 5.25 Pct Debs
ALFA.TO	Accelerate Private Equity Alpha Fund ETF
ALS.TO	Altius Minerals Corp
ALYA.TO	Alithya Group
AMM.TO	Almaden Minerals Ltd
AND.TO	Andlauer Healthcare Group Inc
ANX.TO	Anaconda Mining Inc
AOI.TO	Africa Oil Corp
AOT.TO	Ascot Resources Ltd
AP.UN.TO	Allied Properties Real Estate Inv Trust
APHA.TO	Aphria Inc
APLI.TO	Appili Therapeutics Inc
APR.UN.TO	Automotive Properties REIT
APS.TO	Aptose Biosciences Inc
APY.TO	Anglo Pacific Group Plc
AQA.TO	Aquila Resources Inc
AQN.TO	Algonquin Power and Utilities Corp
AQN.PR.A.TO	Algonquin Power and Utilities Pref A
AQN.PR.D.TO	Algonquin Power and Utilities Pref D
AR.TO	Argonaut Gold Inc
AR.DB.U.TO	Argonaut Gold Inc. 4.625%
ARB.TO	Accelerate Arbitrage Fund ETF
ARE.TO	Aecon Group Inc
ARE.DB.C.TO	Aecon Group Inc 5.0 Pct Debs
ARG.TO	Amerigo Resources Ltd
ARX.TO	Arc Resources Ltd
ASM.TO	Avino Silver and Gold Mines Ltd
ASND.TO	Ascendant Resources Inc
ASND.WT.TO	Ascendant Resources Inc Wts
ASP.TO	Acerus Pharmaceuticals Corp
ASP.RT.TO	Acerus Pharmaceuticals Corp RTS
AT.TO	Acuityads Holdings Inc
ATA.TO	Ats Automation
ATD.A.TO	Alimentation Couche-Tard Inc Cl A Mv
ATD.B.TO	Alimentation Couche-Tard Inc Cl B Sv
ATE.TO	Antibe Therapeutics Inc
ATH.TO	Athabasca Oil Corp
ATP.TO	Atlantic Power Corp
ATP.DB.E.TO	Atlantic Power Corporation 6.00 Pct Debs
ATSX.TO	Accelerate Enhanced CDN Bm Alt Fund ETF
ATZ.TO	Aritzia Inc
AUGB.F.TO	First Trst CBOE Vest US Eqty Buffer ETF
AUMN.TO	Golden Minerals Company
AUP.TO	Aurinia Pharmaceuticals Inc
AVCN.TO	Avicanna Inc
AVL.TO	Avalon Advanced Materials Inc
AVP.TO	Avcorp Industries Inc
AW.UN.TO	A&W Revenue Royalties Income Fund
AX.PR.A.TO	Artis REIT Pref Ser A
AX.PR.E.TO	Artis REIT Pref Ser E
AX.PR.I.TO	Artis REIT Pref Series I
AX.UN.TO	Artis Real Estate Investment Trust Units
AXU.TO	Alexco Resource Corp
AYA.TO	Aya Gold and Silver Inc
AYM.TO	Atalaya Mining Plc
AZP.PR.A.TO	Atlantic Power Pref Equity Ser 1
AZP.PR.B.TO	Atlantic Power Pref Equity Ser 2
AZP.PR.C.TO	Atlantic Power Pref Equity Ser 3
AZZ.TO	Azarga Uranium Corp
BAD.TO	Badger Daylighting Ltd
BAM.A.TO	Brookfield Asset Management Inc Cl.A Lv
BAM.PF.A.TO	Brookfield Asset Mgmt Inc Pref Ser 32
BAM.PF.B.TO	Brookfield Asset Mgmt Inc Pref Ser 34
BAM.PF.C.TO	Brookfield Asset Mgmt Inc Pref Ser 36
BAM.PF.D.TO	Brookfield Asset Mgmt Inc Pr Ser 37
BAM.PF.E.TO	Brookfield Asset Mgmt Pref Ser 38
BAM.PF.F.TO	Brookfield Asset Mgmt Inc Pref Ser 40
BAM.PF.G.TO	Brookfield Asset Mgmt Inc Pref Ser 42
BAM.PF.H.TO	Brookfield Asset MGT Inc Pref Ser 44
BAM.PF.I.TO	Brookfield Asset Mgmt Inc Pref Ser 46
BAM.PF.J.TO	Brookfield Asset Mgmt Inc Pref Ser 48
BAM.PR.B.TO	Brookfield Asset Mgmt Inc Pr. Ser 2
BAM.PR.C.TO	Brookfield Asset Mgmt Inc Pr. Ser 4
BAM.PR.E.TO	Brookfield Asset Mgmt Inc Pr. Ser 8
BAM.PR.G.TO	Brookfield Asset Mgmt Inc Pr Ser 9
BAM.PR.K.TO	Brookfield Asset Mgmt Inc Pr. Ser 13
BAM.PR.M.TO	Brookfield Asset Mgmt Inc Prf A Ser 17
BAM.PR.N.TO	Brookfield Asset Mgmt Pref Shs Ser 18
BAM.PR.R.TO	Brookfield Asset Mgmt Pref Ser 24
BAM.PR.S.TO	Brookfield Asset Mgmt Inc Pref Ser 25
BAM.PR.T.TO	Brookfield Asset Mgmt Pref Ser 26
BAM.PR.X.TO	Brookfield Am Pref Ser 28
BAM.PR.Z.TO	Brookfield Asset Mgmt Inc Pr Ser 30
BASE.TO	Evolve Glob Matls Mining Enh Yld Idx ETF
BASE.B.TO	Evolve Glob Matls Mining Enh Yld Unhgd
BB.TO	Blackberry Limited
BBD.A.TO	Bombardier Inc Cl A Mv
BBD.B.TO	Bombardier Inc Cl B Sv
BBD.PR.B.TO	Bombardier 2 Pr
BBD.PR.C.TO	Bombardier Inc Pref Class C
BBD.PR.D.TO	Bombardier Inc Pref Ser 3
BBL.A.TO	Brampton Brick Ltd Cl.A Sv
BBTV.TO	Bbtv Holdings Inc.
BBU.UN.TO	Brookfield Business Partners LP
BC.U.TO	Bespoke Capital Acquisition Class A USD
BC.WT.U.TO	Bespoke Capital Acquisition Corp WT
BCE.TO	BCE Inc
BCE.PR.A.TO	BCE First Pr Shares Series Aa
BCE.PR.B.TO	BCE Inc First Pr Shares Series Ab
BCE.PR.C.TO	BCE Inc Pr Shares Series AC
BCE.PR.D.TO	BCE Inc Pref Shares Series Ad
BCE.PR.E.TO	BCE 1st Pref Shares Series Ae
BCE.PR.F.TO	BCE 1st Pref Shares Series Af
BCE.PR.G.TO	BCE 1st Pref Shares Series Ag
BCE.PR.H.TO	BCE 1st Pref Shares Series Ah
BCE.PR.I.TO	BCE 1st Pref Shares Series Ai
BCE.PR.J.TO	BCE Inc Pref Sh Series Aj
BCE.PR.K.TO	BCE Inc Pref Ser AK
BCE.PR.L.TO	BCE Inc Pref Ser AL
BCE.PR.M.TO	BCE Inc Pref Shares Series Am
BCE.PR.N.TO	BCE Inc Pref Shares Series An
BCE.PR.O.TO	BCE Inc Pref Shares Series Ao
BCE.PR.Q.TO	BCE Inc Pref Shares Series Aq
BCE.PR.R.TO	BCE Inc Ser R
BCE.PR.S.TO	BCE Inc Ser S
BCE.PR.T.TO	BCE Inc First Pref Series T
BCE.PR.Y.TO	BCE Inc Ser Y Pr
BCE.PR.Z.TO	BCE Inc Series Z
BCI.TO	New Look Vision Group Inc
BDI.TO	Black Diamond Group Ltd
BDIV.TO	Brompton Global Dividend Growth ETF
BDT.TO	Bird Construction Inc
BEI.UN.TO	Boardwalk Real Estate Investment Trust
BEK.B.TO	Becker Milk Company Ltd Cl.B NV
BEP.PR.E.TO	Brookfield Renewable LP Pref Ser 5
BEP.PR.G.TO	Brookfield Renewable LP Pref Ser 7
BEP.PR.I.TO	Brookfield Renewable Pref Ser 9
BEP.PR.K.TO	Brookfield Renewable LP Pref Ser 11
BEP.PR.M.TO	Brookfield Renewable LP Pref Ser 13
BEP.PR.O.TO	Brookfield Renewable Partners L.P.
BEP.UN.TO	Brookfield Renewable Partners LP
BEPC.TO	Brookfield Renewable Corporation
BESG.TO	Invesco ESG CDN Core Plus Bond ETF
BFIN.TO	Brompton Na Financials Dividend ETF
BFIN.U.TO	Brompton Na Financials Dividend ETF USD
BGC.TO	Bristol Gate Concentrated CDN Eqty ETF
BGI.UN.TO	Brookfield Glbl Infras Sec Inc Fd
BGU.TO	Bristol Gate Concentrated US Eqty ETF
BGU.U.TO	Bristol Gate Conc US Eqty ETF USD
BHC.TO	Bausch Health Companies Inc
BIK.PR.A.TO	Bip Investment Corp Pref Ser 1
BIP.PR.A.TO	Brookfield Infra Partners LP Pref Ser 1
BIP.PR.B.TO	Brookfield Infra Partners LP Pref Ser 3
BIP.PR.C.TO	Brookfield Infra Partners LP Pref Ser 5
BIP.PR.D.TO	Brookfield Infra Partners LP Pref Ser 7
BIP.PR.E.TO	Brookfield Infra Partners LP Pref Ser 9
BIP.PR.F.TO	Brookfield Infra Partners LP Pref Ser 11
BIP.UN.TO	Brookfield Infra Partners LP Units
BIPC.TO	Brookfield Infrastructure Corporation
BIR.TO	Birchcliff Energy Ltd
BIR.PR.A.TO	Birchcliff Energy Ltd Pref Sh A
BIR.PR.C.TO	Birchcliff Energy Ltd Pref Ser C
BK.TO	Canadian Banc Corp
BK.PR.A.TO	Canadian Banc Corp Pref A
BKI.TO	Black Iron Inc
BKL.C.TO	Invesco Senior Loan Index ETF
BKL.F.TO	Invesco Senior Loan Index ETF
BKL.U.TO	Invesco Senior Loan Index USD ETF
BL.UN.TO	Global Innovation Dividend Fund
BLB.UN.TO	Bloom Select Income Fund
BLCK.TO	First Trust Indxx Innov Trans Proc ETF
BLDP.TO	Ballard Power Systems Inc
BLU.TO	Bellus Health Inc
BLX.TO	Boralex Inc
BMO.TO	Bank of Montreal
BMO.PR.A.TO	BMO Pref Shares Series 26
BMO.PR.B.TO	BMO Pref Shares Series 38
BMO.PR.C.TO	BMO Pref Shares Series 40
BMO.PR.D.TO	BMO Pref Shares Series 42
BMO.PR.E.TO	BMO Pref Shares Series 44
BMO.PR.F.TO	BMO Pref Shares Series 46
BMO.PR.Q.TO	Bank of Montreal B Pref Sh Ser 25
BMO.PR.S.TO	BMO Cl B Pref Shares Ser 27
BMO.PR.T.TO	BMO Non Cum Cl B Prf Share Series 29
BMO.PR.W.TO	BMO Cl B Pref Shares Ser 31
BMO.PR.Y.TO	Bank of Montreal Pref Ser 33
BMO.PR.Z.TO	Bank of Montreal Pref Ser 35
BNAU.TO	Battle North Gold Corp
BNC.TO	Purpose CDN Financial Income Fund ETF
BND.TO	Purpose Tactical Inv Grade Bond ETF
BNE.TO	Bonterra Energy Corp
BNG.TO	Bengal Energy Ltd
BNK.TO	Bankers Petroleum Ltd.
BNK.PR.A.TO	Big Banc Split Corp
BNS.TO	Bank of Nova Scotia
BNS.PR.E.TO	Bns Pref Shares Series 34
BNS.PR.F.TO	Bns Pref Shares Series 33
BNS.PR.G.TO	Bns Pref Shares Series 36
BNS.PR.H.TO	Bns Pref Shares Series 38
BNS.PR.I.TO	Bns Preferred Shares Series 40
BNS.PR.Z.TO	Bns Pref Ser 32
BOS.TO	Airboss America J
BPF.UN.TO	Boston Pizza Royalties Income Fund
BPO.PR.A.TO	Brookfield Office Properties Pref Ser Aa
BPO.PR.C.TO	Brookfield Office Properties Pref Ser CC
BPO.PR.E.TO	Brookfield Office Properties Pref Ser Ee
BPO.PR.G.TO	Brookfield Office Properties Pref Ser G
BPO.PR.I.TO	Brookfield Office Properties Pref Ser II
BPO.PR.N.TO	Brookfield Office Properties Pref Ser N
BPO.PR.P.TO	Brookfield Office Properties Pref Ser P
BPO.PR.R.TO	Brookfield Office Properties Pref Ser R
BPO.PR.S.TO	Brookfield Office Properties Pref Ser S
BPO.PR.T.TO	Brookfield Office Properties Pref Ser T
BPO.PR.W.TO	Brookfield Office Properties Pref Ser W
BPO.PR.X.TO	Brookfield Office Properties Pref Ser V
BPO.PR.Y.TO	Brookfield Office Properties Pref Ser Y
BPRF.TO	Bf and Crumrine Invest Grade Pref ETF
BPRF.U.TO	Bf and Crumrine Invgrade Pref ETF USD
BPS.PR.A.TO	Brookfield Property Split Pref Ser 2
BPS.PR.B.TO	Brookfield Property Split Pref Ser 3
BPS.PR.C.TO	Brookfield Property Split Pref Ser 4
BPS.PR.U.TO	Brookfield Property Split Pref Ser 1
BPY.UN.TO	Brookfield Property Partners LP
BR.TO	Big Rock Brewery Inc
BRE.TO	Brookfield Real Estate Services Inc
BREA.TO	Brompton Global Real Assets Dividend ETF
BRF.PR.A.TO	Brookfield Renewable Pref Cl A Ser 1
BRF.PR.B.TO	Brookfield Renewable Pref Cl A Ser 2
BRF.PR.C.TO	Brookfield Renewable Power Pref Eqty Inc
BRF.PR.E.TO	Brookfield Renewable Power Pref Eqt Sr 5
BRF.PR.F.TO	Brookfield Renewable Power Pref Eqt Sr 6
BRY.TO	Bri Chem Corp
BSKT.TO	Manulife Smart Core Bond ETF
BSO.UN.TO	Brookfield Select Opportunities Inc Fund
BSX.TO	Belo Sun Mining Corp
BTB.DB.G.TO	Btb REIT 6.0 Pct Debs
BTB.DB.H.TO	Btb REIT 7.00 Pct Debs
BTB.UN.TO	Btb REIT Units
BTCG.U.TO	CI Galaxy Bitcoin Fund USD
BTCG.UN.TO	CI Galaxy Bitcoin Fund
BTE.TO	Baytex Energy Corp
BTO.TO	B2Gold Corp
BU.TO	Burcon Nutrascience Corp
BUA.UN.TO	Bloom US Income and Growth Fund
BUI.TO	Buhler Ind
BXF.TO	CI First Asset 1 To 5 Yr Lad Gov Stp Bd ETF
BXS.DB.C.TO	Barclays Bank Fixed Rate Notes I 28
BYD.TO	Boyd Group Services Inc
BYL.TO	Baylin Technologies Inc
BYL.DB.TO	Baylin Technologies Inc 6.5 Pct Debs
CACB.TO	CIBC Active Invst Grade Corp Bond ETF
CAE.TO	Cae Inc
CAFR.TO	CIBC Act Invst Grade Float Rate Bond ETF
CAGG.TO	CI Yield Enh CDN Agrt Bond ETF
CALL.TO	Evolve US Banks Enhanced Yield ETF
CALL.B.TO	Evolve US Banks Enhanced Yield Unheg
CALL.U.TO	Evolve US Banks Enhanced Yld Fd ETF USD
CAR.UN.TO	CDN Apartment Un
CARS.TO	Evolve Automobile Innovation Idx Hgd ETF
CARS.B.TO	Evolve Automobile Innovation Idx Uh ETF
CARS.U.TO	Evolve Automobile Innovation Idx Fd USD
CAS.TO	Cascades Inc
CBH.TO	Ishares 1-10 Yr Laddered Corp Bond ETF
CBO.TO	Ishares 1-5Yr Laddered Corp Bond ETF
CCA.TO	Cogeco Communications Inc
CCL.A.TO	Ccl Inc Cl A
CCL.B.TO	Ccl Industries Inc Cl B NV
CCM.TO	Canarc Res J
CCNS.TO	CIBC Conservative Fixed Income Pool ETF
CCO.TO	Cameco Corp
CCOR.TO	CI Doubleline Cor Plus Fxd Inc US HD ETF
CCOR.B.TO	CI Doubleline Cor Plus Fxd Inc US Uh ETF
CCRE.TO	CIBC Core Fixed Income Pool ETF
CCS.PR.C.TO	Co-Operators Gen Ins Cl E Prf
CDAY.TO	Ceridian Hcm Holdings Inc
CDD.UN.TO	Core Canadian Dividend Trust
CDIV.TO	Manulife Smart Dividend ETF
CDLB.TO	CI Doubleline Total Return Bnd US HD ETF
CDLB.B.TO	CI Doubleline Total Return Bnd US Uh ETF
CDLB.U.TO	CI Doubleline Total Retrn Bnd US ETF USD
CDV.TO	Cardinal Resources Limited
CDZ.TO	Ishares S&P TSX CDN Dividend ETF
CEE.TO	Centamin Plc
CEF.TO	Sprott Physical Gold Silver Trust
CEF.U.TO	Central Fund of Canada Ltd Cl.U NV
CERV.TO	Cervus Equipment Corp
CET.TO	Cathedral Energy Services Ltd
CEU.TO	Ces Energy Solutions Corp
CEW.TO	Ishares Equal Weight Banc Lifeco ETF
CF.TO	Canaccord Genuity Group Inc
CF.DB.A.TO	Canaccord Genuity Group 6.25 Pct Debs
CF.PR.A.TO	Canaccord Genuity Group Inc Pref A
CF.PR.C.TO	Canaccord Genuity Group Inc Pref C
CFF.TO	Conifex Timber Inc
CFLX.TO	CIBC Flexible Yield ETF Hedged
CFP.TO	Canfor Corp
CFW.TO	Calfrac Well Services Ltd
CFX.TO	Canfor Pulp Products Inc
CG.TO	Centerra Gold Inc
CGAA.TO	CI First Asset Glb Asset Allocation ETF
CGG.TO	China Gold Int Resources Corp
CGI.TO	CDN General Inv
CGI.PR.D.TO	Canadian General Inv Ltd Pref Ser 4
CGL.TO	Ishares Gold Bullion ETF Hdg
CGL.C.TO	Ishares Gold Bullion ETF Non Hdg
CGLO.TO	CIBC Global Growth ETF
CGO.TO	Cogeco Inc Sv
CGR.TO	Ishares Global Real Estate ETF
CGRA.TO	CI Global Real Asset Private Pool ETF
CGRE.TO	CI Global REIT Private Pool ETF
CGX.TO	Cineplex Inc
CGX.DB.B.TO	Cineplex Inc Debs
CGXF.TO	CI First Asset Gold Giants Cvr Call ETF
CGY.TO	Calian Group Ltd
CHB.TO	Ishares US HY Fixed Income Index ETF
CHE.DB.C.TO	Chemtrade Logistics Income Fund 5.0 Debs
CHE.DB.D.TO	Chemtrade Logistics Inc Fd 4.75 Pct Debs
CHE.DB.E.TO	Chemtrade Logistics If 6.50 Pct Debs
CHE.DB.F.TO	Chemtrade Logistics If 8.50 Pct Debs
CHE.UN.TO	Chemtrade Logistics Income Fund
CHNA.B.TO	CI Icbccs SP China 500 Index ETF
CHP.UN.TO	Choice Properties REIT
CHR.TO	Chorus Aviation Inc
CHR.DB.A.TO	Chorus Aviation Inc 5.75 Pct Debs
CHW.TO	Chesswood Group Limited
CIA.TO	Champion Iron Limited
CIC.TO	CI First Asset Canbanc Income Class ETF
CIF.TO	Ishares Global Infrastructure Index ETF
CIGI.TO	Colliers International Group Inc
CINC.TO	CI Doubleline Income US Hdg ETF
CINC.B.TO	CI Doubleline Income US Unhedged ETF
CINC.U.TO	CI Doubleline Income US ETF USD
CINF.TO	CI Global Infrastructure Pvt Pool ETF
CINT.TO	CIBC International Equity ETF
CIQ.UN.TO	Canadian High Income Equity Fund
CIU.PR.A.TO	Cu Inc Pref Shares
CIU.PR.C.TO	Cu Inc Pref Ser 4
CIX.TO	CI Financial Corp
CJ.TO	Cardinal Energy Ltd
CJ.DB.TO	Cardinal Energy Ltd 5.50 Pct Debs
CJ.DB.A.TO	Cardinal Energy Ltd 8 Pct Debs
CJR.B.TO	Corus Entertainment Inc Cl.B NV
CJT.TO	Cargojet Inc
CJT.DB.D.TO	Cargojet Inc 5.75 Pct Debs
CJT.DB.E.TO	Cargojet Inc 5.75 Pct Debs
CJT.DB.F.TO	Cargojet Inc 5.25 Pct Debs
CKI.TO	Clarke Inc
CKI.DB.TO	Clarke Inc 6.25 Pct Debs
CLF.TO	Ishares 1-5 Yr Ladder Govt Bond ETF
CLG.TO	Ishares 1-10 Yr Ladder Govt Bond ETF
CLIQ.TO	Alcanna Inc
CLIQ.DB.TO	Alcanna Inc 4.70 Pct Debs
CLR.TO	Clearwater Seafoods Incorporated
CLS.TO	Celestica Inc Sv
CM.TO	Canadian Imperial Bank of Commerce
CM.PR.O.TO	CIBC Pref Ser 39
CM.PR.P.TO	CIBC Pref Ser 41
CM.PR.Q.TO	CIBC Pref Ser 43
CM.PR.R.TO	CIBC Pref Ser 45
CM.PR.S.TO	CIBC Pref Series 47
CM.PR.T.TO	CIBC Pref Series 49
CM.PR.Y.TO	CIBC Pref Series 51
CMAG.TO	CI Munro Alt Global Growth ETF
CMAR.TO	CI Marret Alt Absolute Return Bnd ETF
CMAR.U.TO	CI Marret Alt Absolute Rtrn Bnd ETF USD
CMCE.TO	CIBC Multifactor Canadian Equity ETF
CMEY.TO	CI Marret Alternative Enhanced Yield ETF
CMG.TO	Computer Modelling Group Ltd
CMMC.TO	Copper Mountain Mining Corp
CMR.TO	Ishares Premium Money Market ETF
CMUE.TO	CIBC Multifactor US Equity ETF
CMUE.F.TO	CIBC Multifactor US Equity ETF Hedged
CNE.TO	Canacol Energy Ltd
CNQ.TO	CDN Natural Res
CNR.TO	Canadian National Railway Co.
CNT.TO	Century Global Commodities Corp
CNU.TO	Cnooc Limited
COG.TO	Condor Gold Plc
COMM.TO	BMO Global Communications Index ETF
CORP.TO	Exemplar Investment Grade Fund
COW.TO	Ishares Global Agri Index ETF
CP.TO	Canadian Pacific Railway Limited
CPD.TO	Ishares S&P TSX CDN Pref ETF
CPG.TO	Crescent Point Energy Corp
CPH.TO	Cipher Pharmaceuticals Inc
CPI.TO	Condor Petroleum Inc
CPLS.TO	CIBC Core Plus Fixed Income Pool ETF
CPX.TO	Capital Power Corp
CPX.PR.A.TO	Capital Power Corporation Pref Ser 1
CPX.PR.C.TO	Capital Power Corp Pref Ser 3
CPX.PR.E.TO	Capital Power Corporation Pref Ser 5
CPX.PR.G.TO	Capital Power Corporation Pref Ser 7
CPX.PR.I.TO	Capital Power Corporation Pref Ser 9
CPX.PR.K.TO	Capital Power Corporation Pref Series 11
CR.TO	Crew Energy Inc
CRDL.TO	Cardiol Therapeutics Inc
CRDL.WT.TO	Cardiol Therapeutics Inc WT
CRED.TO	CI Lawrence Park Alt Invest Grd Crdt ETF
CRED.U.TO	CI Lawrence Park Alt Inv Grd Crt ETF USD
CRH.TO	CRH Medical Corp
CRON.TO	Cronos Group Inc
CRP.TO	Ceres Global Ag Corp
CRR.UN.TO	Crombie Real Estate Investment Trust
CRRX.TO	Carerx Corporation
CRT.UN.TO	CT Real Estate Investment Trust
CRWN.TO	Crown Capital Partners Inc
CRWN.DB.TO	Crown Capital Partners Inc 6.0 Pct Debs
CS.TO	Capstone Mining Corp
CSAV.TO	CI First Asset High Interest Savings ETF
CSD.TO	Ishares Short Dur HI Inc ETF CAD Hgd
CSE.PR.A.TO	Capstone Infrastructure Corp Pref A
CSH.UN.TO	Chartwell Retirement Residences
CSM.TO	Clearstream Energy Services Inc
CSU.TO	Constellation Software Inc
CSU.DB.TO	Constellation Software Inc Debs Ser 1
CSW.A.TO	Corby Spirit and Wine Ltd Class A
CSW.B.TO	Corby Spirit and Wine Ltd Class B
CSY.TO	CI First Asset Core Can Equity Inc Class ETF
CTC.TO	Canadian Tire Corporation Limited
CTC.A.TO	Canadian Tire Corporation Cl A NV
CTF.UN.TO	Citadel Income Fund
CTX.TO	Crescita Therapeutics Inc
CU.TO	Canadian Utilities Ltd Cl.A NV
CU.PR.C.TO	Canadian Utilities Limited Pref Ser C
CU.PR.D.TO	Canadian Utilities Ltd Pr Series Aa
CU.PR.E.TO	Canadian Utilities Ltd Pref Ser Bb
CU.PR.F.TO	Canadian Utilities Ltd Pref Ser CC
CU.PR.G.TO	Canadian Utilities Ltd Pref Ser Dd
CU.PR.H.TO	Canadian Utilities Ltd Pref Ser Ee
CU.PR.I.TO	Canadian Utilities Ltd Pref Ser Ff
CU.X.TO	CDN Util Cl B
CUD.TO	Ishares S&P US Div Growers ETF
CUF.UN.TO	Cominar R E Un
CUP.U.TO	Caribbean Util US
CVD.TO	Ishares Convertible Bond Index ETF
CVE.TO	Cenovus Energy Inc
CVG.TO	Clairvest Group
CWB.TO	CDN Western Bank
CWB.PR.B.TO	Canadian Western Bank Pref Ser 5
CWB.PR.C.TO	Canadian Western Bank Pref Ser 7
CWB.PR.D.TO	Canadian Western Bank Pref Series 9
CWEB.TO	Charlotte's Web Holdings Inc
CWEB.WR.TO	Charlottes Web Holdings Inc Wr
CWEB.WS.TO	Charlottes Web Holdings Inc Ws
CWEB.WT.TO	Charlottes Web Holdings Inc
CWL.TO	Caldwell Partners International Inc
CWW.TO	Ishares S&P Global Water ETF
CWX.TO	Canwel Building Materials Group Ltd
CWX.NT.A.TO	Canwel Build Materials 6.375 Pct Notes
CXB.TO	Calibre Mining Corp
CXF.TO	CI First Asset CDN Convert Bond ETF
CXI.TO	Currency Exchange International Corp
CYB.TO	Cymbria Corporation Cl A
CYBR.TO	Evolve Cyber Security Index Hgd ETF
CYBR.B.TO	Evolve Cyber Security Index Uh ETF
CYBR.U.TO	Evolve Cyber Security Index Uh Fund USD
CYH.TO	Ishares Global Monthly Dividend ETF
D.UN.TO	Dream Office REIT
DANC.TO	Desjardins Lng Shrt Eqty Mkt Ntrl ETF
DBO.TO	Dbox Technologies Inc
DC.A.TO	Dundee Corp Cl.A Sv
DC.PR.B.TO	Dundee Corp First Pref Ser 2
DC.PR.D.TO	Dundee Corp Pref Ser 3
DCBO.TO	Docebo Inc
DCC.TO	Desjardins 1To5 Yr Lad CDN Corp Bd ETF
DCG.TO	Desjardins 1To5 Yr Lad CDN Govt Bd ETF
DCM.TO	Data Communications Mgmt Corp
DCP.TO	Desjardins CDN Pref Share ETF
DCS.TO	Desjardins CDN Short Term Bd ETF
DCU.TO	Desjardins CDN Universe Bond Index ETF
DF.TO	Dividend 15 Split Corp II
DF.PR.A.TO	Dividend 15 Split Corp II Prf
DFC.TO	Desjardins Cda Multifactor Ctrl Vol ETF
DFD.TO	Desjardins Dev Xus Xcda Mltifact Vol ETF
DFE.TO	Desjardins EM Multifactor-Controlled Vol ETF
DFN.TO	Dividend 15 Split Corp
DFN.PR.A.TO	Dividend 15 Split Corp
DFU.TO	Desjardins USA Multifactor Ctrl Vol ETF
DGR.TO	CI Wisdomtree US Quality Div Growth Index ETF
DGR.B.TO	CI Wisdomtree US Quality Div Growth Index ETF
DGRC.TO	CI Wisdomtree CDN Qlty Div Gwth Idx ETF
DGS.TO	Dividend Growth Split Corp Class A
DGS.PR.A.TO	Dividend Growth Split Corp Pref
DIAM.TO	Star Diamond Corp
DII.A.TO	Dorel Industries Inc Cl.A Mv
DII.B.TO	Dorel Industries Inc Cl.B Sv
DIR.UN.TO	Dream Industrial REIT
DISC.TO	BMO Glb Consumer Disc Hgd To CAD ETF
DIV.TO	Diversified Royalty Corp
DIV.DB.TO	Diversified Royalty Corp 5.25 Pct Debs
DIVS.TO	Evolve Active CDN Pref Share ETF
DLR.TO	Horizons US Dollar Currency ETF
DLR.U.TO	Horizons US Dollar Currency ETF USD
DML.TO	Denison Mines Corp
DN.TO	Delta 9 Cannabis Inc
DN.DB.TO	Delta 9 Cannabis Inc 8.5 Pct Debs
DN.WT.A.TO	Delta 9 Cannabis Inc WT A
DND.TO	Dye & Durham Ltd
DNG.TO	Dynacor Gold Mines Inc
DNT.TO	Candente Copper Corp
DOL.TO	Dollarama Inc
DOO.TO	Brp Inc
DPM.TO	Dundee Precious Metals Inc
DQD.TO	CI Wisdomtree Y.S. Qlty Divd Gwth Var Hgd ETF
DQI.TO	CI Wisdomtree Intl Qlty Div Gwth Var Hgd ETF
DR.TO	Medical Facilities Corp
DRCU.TO	Desjardins RI Active Canadian Bond-Low C
DRFC.TO	Desjardins RI Cda Multi Low Co2 ETF
DRFD.TO	Desjardins RI Dev Ex USA Ex Cda Co2 ETF
DRFE.TO	Desjardins Emerging Mkts Low Co2 ETF
DRFG.TO	Desjardins Gbl Fossil Fuel Res Free ETF
DRFU.TO	Desjardins RI USA Multi Low Co2 ETF
DRM.TO	Dream Unlimited Corp
DRMC.TO	Desjardins RI Canada-Low Co2 Index ETF
DRMD.TO	Desjardins RI Dev Exusa Exca Low Co2 ETF
DRMU.TO	Desjardins RI USA Low Co2 Index ETF
DRT.TO	Dirtt Environmental Solutions Ltd
DRX.TO	Adf Group Inc Sv
DS.TO	Dividend Select 15 Corp
DSG.TO	Descartes Sys
DXB.TO	Dynamic Ishares Act Tactical Bond ETF
DXC.TO	Dyn Ishares Active CDN Div ETF
DXF.TO	Dynamic Ishares Act Global Fin Ser ETF
DXG.TO	Dyn Ishares Active Global Div ETF
DXM.TO	CI First Asset Morningstar Cda Div Tgt 30 ETF
DXN.TO	Dynamic Active Global Infrastructure ETF
DXO.TO	Dyn Ishares Act Crossover Bond ETF
DXP.TO	Dyn Ishares Active Pref Shares ETF
DXT.TO	Dexterra Group Inc
DXU.TO	Dyn Ishares Active US Div ETF
DXV.TO	Dyn Ishares Act Inv Grd Flot Rt ETF
DXW.TO	Dynamic Active Intl Dividend ETF
DXZ.TO	Dynamic Ishares Acitve US Mid Cap ETF
DYA.TO	Dynacert Inc
DYA.WT.TO	Dynacert Inc
E.TO	Enterprise Group Inc
EARN.TO	Evolve Active Global Fixed Income ETF
ECN.TO	Ecn Capital Corp
ECN.DB.TO	Ecn Capital Corp 6.0 Pct Debs
ECN.PR.A.TO	Ecn Capital Corp Pref Ser A
ECN.PR.C.TO	Ecn Capital Corp Pref Ser C
ECO.TO	Ecosynthetix Inc
EDGE.TO	Evolve Innovation Index ETF
EDGF.TO	Brompton European Div Growth ETF
EDR.TO	Endeavour Silver Corp
EDT.TO	Spectral Medical Inc
EDV.TO	Endeavour Mining Corp
EFH.TO	Echelon Financial Holdings Inc
EFL.TO	Electrovaya Inc
EFN.TO	Element Fleet Management Corp
EFN.DB.B.TO	Element Fleet Management 4.25 Pct Debs
EFN.PR.A.TO	Element Fleet Mgmt Corp Pref Ser A
EFN.PR.C.TO	Element Fleet Mgmt Corp Pref Ser C
EFN.PR.E.TO	Element Fleet Mgmt Corp Pref Ser E
EFN.PR.I.TO	Element Fleet Mgmt Corp Pref Ser I
EFR.TO	Energy Fuels Inc
EFR.WT.TO	Energy Fuels Inc WT
EFX.TO	Enerflex Ltd
EGIF.TO	Exemplar Growth and Income Fund ETF
EGLX.TO	Enthusiast Gaming Holdings Inc
EHE.TO	CI Wisdomtree Europe Hedged Equity Index ETF
EHE.B.TO	CI Wisdomtree Europe Hedged Equity Index ETF
EIF.TO	Exchange Income Corp
EIF.DB.H.TO	Exchange Income Corp 5.25 Pct Debs
EIF.DB.I.TO	Exchange Income Corp 5.25 Pct Debs
EIF.DB.J.TO	Exchange Income Corp 5.35 Pct Debs
EIF.DB.K.TO	Exchange Income Corp 5.75 Pct Debs
EIT.PR.A.TO	Canoe Eit Income Fund Pref Ser 1
EIT.PR.B.TO	Canoe Eit Income Fund Pref Ser 2
EIT.UN.TO	Canoe Eit Income Fund Units
ELD.TO	Eldorado Gold
ELEF.TO	Silver Elephant Mining Corporation
ELF.TO	E-L Financial
ELF.PR.F.TO	E-L Financial Corp Ltd Pr Ser. 1
ELF.PR.G.TO	E- L Financial Corp Limited
ELF.PR.H.TO	E - L Financial Corp Ltd Pref Ser 3
ELR.TO	Eastern Platinum Limited
ELV.TO	Powershares S&P Emg Mkts Low Vol ETF
EMA.TO	Emera Incorporated
EMA.PR.A.TO	Emera Inc Series A Pref
EMA.PR.B.TO	Emera Inc Pref Sh Series B
EMA.PR.C.TO	Emera Inc Pref Sh Series C
EMA.PR.E.TO	Emera Inc Pref Ser E
EMA.PR.F.TO	Emera Inc Series F Pref
EMA.PR.H.TO	Emera Inc Pref Series H
EML.PR.A.TO	The Empire Life Insurance CO Pref A
EMP.A.TO	Empire Company Limited
EMV.B.TO	CI Wisdomtree Emerging Mkt Divd Index ETF
ENB.TO	Enbridge Inc
ENB.PF.A.TO	Enbridge Inc Pref Ser 9
ENB.PF.C.TO	Enbridge Inc Pref Ser 11
ENB.PF.E.TO	Enbridge Inc Pref Ser 13
ENB.PF.G.TO	Enbridge Inc Pref Ser 15
ENB.PF.I.TO	Enbridge Inc Pref Ser 17
ENB.PF.K.TO	Enbridge Inc Pref Series 19
ENB.PF.U.TO	Enbridge Inc Pref Ser L
ENB.PF.V.TO	Enbridge Inc Pref Ser 5 USD
ENB.PR.A.TO	Enbridge Pr
ENB.PR.B.TO	Enbridge Inc Cum Redeem Pref Ser B
ENB.PR.C.TO	Enbridge Inc Pref Ser C
ENB.PR.D.TO	Enbridge Inc Pref Ser D
ENB.PR.F.TO	Enbridge Inc Pref Ser F
ENB.PR.H.TO	Enbridge Inc Pref Ser H
ENB.PR.J.TO	Enbridge Inc Pref Ser 7
ENB.PR.N.TO	Enbridge Inc Pref Ser N
ENB.PR.P.TO	Enbridge Inc Pref Ser P
ENB.PR.T.TO	Enbridge Inc Pref Ser R
ENB.PR.U.TO	Enbridge Inc Pref Sh Series J
ENB.PR.V.TO	Enbridge Inc Pref Ser 1
ENB.PR.Y.TO	Enbridge Inc Cum Red Pref Ser 3
ENGH.TO	Enghouse Systems Limited
ENI.UN.TO	Energy Income Fund
ENS.TO	E Split Corp
ENS.PR.A.TO	E Split Corp Pref Shares
EOX.TO	Euromax Resources Ltd
EQB.TO	Equitable Group Inc
EQB.PR.C.TO	Equitable Group Inc Pref Ser 3
EQL.TO	Invesco S&P 500 Eql Weight Idx ETF
EQL.F.TO	Invesco S&P 500 Eql Weight Idx ETF Hgd
EQL.U.TO	Invesco S&P 500 Eql Weight Idx ETF USD
EQX.TO	Equinox Gold Corp
EQX.WT.TO	Equinox Gold Corp WT
ERD.TO	Erdene Resource Development Corp
ERE.UN.TO	European Residential Real Estate Invs. Trust
ERF.TO	Enerplus Corp
ERO.TO	Ero Copper Corp
ESG.TO	Invesco S&P 500 ESG Index ETF
ESG.F.TO	Invesco S&P 500 ESG Index ETF Hedged
ESGA.TO	BMO MSCI Canada ESG Leaders Index ETF
ESGB.TO	BMO ESG Corporate Bond Index ETF
ESGC.TO	Invesco SP TSX Composite ESG Index ETF
ESGE.TO	BMO MSCI EAFE ESG Leaders Index ETF
ESGF.TO	BMO ESG US Corp Bnd Hdgd To CAD Idx ETF
ESGG.TO	BMO MSCI Global ESG Leaders Index ETF
ESGY.TO	BMO MSCI USA ESG Leaders Index ETF
ESI.TO	Ensign Energy Services Inc
ESM.TO	Euro Sun Mining Inc
ESN.TO	Essential Energy Services Ltd
ET.TO	Evertz Technologies Limited
ETG.TO	Entree Resources Ltd
ETHI.TO	Horizons Global Sustain Leaders Idx ETF
ETP.TO	First Trust Global Risk Managed Inc ETF
ETP.A.TO	First Trust Glb Risk Managed Inc ETF AC
ETX.TO	Etrion Corp
EUR.TO	First Trust Alphadex Euro Div ETF
EVT.TO	Economic Investment
EXE.TO	Extendicare Inc
EXE.DB.C.TO	Extendicare Inc 5 Pct Debs
EXF.TO	Exfo Inc
EXN.TO	Excellon Resources Inc
EXN.WT.TO	Excellon Resources Inc WT
FAF.TO	Fire & Flower Holdings Corp.
FAH.U.TO	Fairfax Africa Holdings Corp
FAI.TO	CI First Asset Active Util&Infrastructure ETF
FAO.TO	CI First Asset Active Credit ETF
FAO.U.TO	CI Fa Active Credit ETF USD
FAP.TO	Aberdeen Asia-Pacific Income Invest Ltd
FAR.TO	Foraco International Sa
FBE.TO	CI First Asset Canadian Buyback Index ETF
FBU.TO	CI First Asset US Buyback Index ETF
FC.TO	Firm Capital Mortgage Inv. Corp
FC.DB.E.TO	Firm Cap Mtg Invest Corp 5.30 Pct Debs
FC.DB.F.TO	Firm Capital Mortgage 5.50 Pct Debs
FC.DB.G.TO	Firm Capital Mortgage Inv 5.20 Pct Debs
FC.DB.H.TO	Firm Capital Mortgage 5.30 Pct Debs
FC.DB.I.TO	Firm Capital Mtg Inv Corp 5.40 Pct Debs
FC.DB.J.TO	Firm Capital Mtg Inv Corp 5.5 Pct Debs
FCCB.TO	Fidelity Systematic CDN Bond Index ETF
FCCD.TO	Fidelity CDN High Div Index ETF
FCCL.TO	Fidelity Canadian Low Vol Index ETF
FCCM.TO	Fidelity Canadian Momentum Index ETF
FCCQ.TO	Fidelity Canadian High Quality Index ETF
FCCV.TO	Fidelity Canadian Value Index ETF
FCGB.TO	Fidelity Global Core Plus Bond ETF
FCGI.TO	Fidelity Global Monthly High Income ETF
FCHH.TO	Fidelity Systematic US HI Yld Bd Cn ETF
FCHY.TO	Fidelity Systematic US High Yld Bond ETF
FCID.TO	Fidelity Intl High Dividend Index ETF
FCIG.TO	Fidelity Global Investment Grade Bnd ETF
FCIL.TO	Fidelity Intl Low Vol Index ETF
FCIM.TO	Fidelity International Momentum Idx ETF
FCIQ.TO	Fidelity Intl High Quality Index ETF
FCIV.TO	Fidelity International Value Index ETF
FCLH.TO	Fidelity US Low Vol Cur Ntrl Index ETF
FCMH.TO	Fidelity US Momentum Cur Neut Index ETF
FCMI.TO	Fidelity CDN Monthly High Income ETF
FCMO.TO	Fidelity US Momentum Index ETF
FCQH.TO	Fidelity US High Qlty Cur Ntrl Index ETF
FCR.UN.TO	First Capital REIT Units
FCRH.TO	Fidelity US Div Rising Rates Cur Neu Idx
FCRR.TO	Fidelity US Div For Rising Rates Idx ETF
FCSB.TO	Fidelity Canadian Short Term Corp Bd ETF
FCU.TO	Fission Uranium Corp
FCUD.TO	Fidelity US High Div Index ETF
FCUH.TO	Fidelity US High Div Cur Neu Idx ETF
FCUL.TO	Fidelity US Low Vol Index ETF
FCUQ.TO	Fidelity US High Quality Index ETF
FCUV.TO	Fidelity US Value Index ETF
FCVH.TO	Fidelity US Value Currency Neut Idx ETF
FDE.TO	First Trust Alphadex Emg Mkt Div ETF CAD
FDV.TO	CI First Asset Active CDN Divd ETF
FEBB.F.TO	First Trust CBOE Vest US Eqty ETF Feb
FEC.TO	Frontera Energy Corp
FF.TO	First Mining Gold Corp
FFH.TO	Fairfax Financial Holdings Ltd
FFH.PR.C.TO	Fairfax Fncl Holdings Ltd Pref Ser C
FFH.PR.D.TO	Fairfax Fncl Holdings Ltd Pref Ser D
FFH.PR.E.TO	Fairfax Financial Hldngs Pref Ser E
FFH.PR.F.TO	Fairfax Financial Holdings Pref Ser F
FFH.PR.G.TO	Fairfax Financial Hldngs Pref Ser G
FFH.PR.H.TO	Fairfax Fncl Holdings Ltd Pref Ser H
FFH.PR.I.TO	Fairfax Financial Holdings Series I Pref
FFH.PR.J.TO	Fairfax Fncl Holdings Ltd Pref Ser J
FFH.PR.K.TO	Fairfax Financial Holdings Pref Ser K
FFH.PR.M.TO	Fairfax Financial Holdings Pref Ser M
FFH.U.TO	Fairfax Financial Holdings Limited USD
FFI.UN.TO	Flaherty & Crumrine Fixed Income Fund
FFN.TO	North American Financial 15 Split Corp
FFN.PR.A.TO	North American Fin 15 Split Corp Pref
FGB.TO	CI First Asset Shrt Term Govt Bond Indx Cl ETF
FGGE.TO	Franklin Global Growth Active ETF
FGO.TO	CI First Asset Enhanced Govt Bond ETF
FGO.U.TO	CI First Asset Enhanced Govt Bond ETF USD
FHB.TO	CI First Asset European Bank ETF
FHC.TO	First Trust US Consmr Staples ETF
FHD.TO	First Trust US Consmr Dscrtn ETF
FHE.TO	First Trust US Energy ETF
FHF.TO	First Trust US Financial ETF
FHG.TO	First Trust US Industrials ETF
FHG.F.TO	First Trust Ad US Industrials ETF
FHH.TO	First Trust US Health Care ETF
FHH.F.TO	First Trust Ad US Health Care ETF
FHI.TO	CI First Asset Hlth Care Giants Cov Call ETF
FHI.B.TO	CI First Asset Hlth Care Giants Cov Call ETF
FHM.TO	First Trust US Materials ETF
FHQ.TO	First Trust US Technology ETF
FHQ.F.TO	First Trust Ad US Technology ETF
FHU.TO	First Trust US Utilities ETF
FIE.TO	Ishares CDN Fin Mthly Income ETF
FIG.TO	CI First Asset Investment Grade Bond ETF
FIG.U.TO	CI First Asset Investment Grade Bond ETF USD
FIH.U.TO	Fairfax India Holdings Corporation USD
FINT.TO	First Trust Intl Capital Strength ETF
FIRE.TO	The Supreme Cannabis Company Inc
FIRE.DB.TO	The Supreme Cannabis CO Inc 6.00 Pct Deb
FLAM.TO	Franklin FTSE US Index ETF
FLBA.TO	Franklin Liberty Core Balanced ETF
FLCD.TO	Franklin FTSE Canada All Cap Index ETF
FLCI.TO	Franklin Liberty CDN Invest Grd Corp ETF
FLCP.TO	Franklin Liberty Core Plus Bond ETF
FLDM.TO	Franklin Libertyqt Intl Eqt Index ETF
FLEM.TO	Franklin Libertyqt Emerging Mkts Idx ETF
FLGA.TO	Franklin Liberty Global Agg Bond ETF
FLGD.TO	Franklin Libertyqt Glb Dividend Idx ETF
FLI.TO	CI First Asset US Cda Lifeco Income ETF
FLJA.TO	Franklin FTSE Japan Index ETF
FLOT.TO	Purpose Floating Rate Income Fund ETF
FLOT.U.TO	Purpose Floating Rate Income Fund USD
FLRM.TO	Franklin Liberty Risk Mngd CDN Eqt ETF
FLSD.TO	Franklin Liberty Short Duration Bond ETF
FLUI.TO	Franklin Liberty US Invest Grd Corp ETF
FLUR.TO	Franklin FTSE Europe Ex UK Index ETF
FLUS.TO	Franklin Libertyqt US Eqt Index ETF
FM.TO	First Quantum Minerals Ltd
FN.TO	First National Financial Corp
FN.PR.A.TO	First National Financial Corp Pref A
FN.PR.B.TO	First National Financial Corp Pref B
FNV.TO	Franco-Nevada Corp
FOOD.TO	Goodfood Market Corp
FOOD.DB.TO	Goodfood Market Corp 5.75 Pct Debs
FORZ.TO	Forza Petroleum Limited
FOUR.TO	Horizons Industry 4.0 Index ETF
FPR.TO	CI First Asset Pref Share ETF
FQC.TO	CI First Asset MSCI Can Quality Index Class ETF
FR.TO	First Majestic Silver Corp Common
FRII.TO	Freshii Inc
FRL.UN.TO	Senior Secured Floating Rate Loan Fund
FRU.TO	Freehold Royalties Ltd
FRU.R.TO	Freehold Royalties Ltd Sub Receipts
FRX.TO	Fennec Pharmaceuticals Inc
FSB.TO	CI First Asset Enhanced Sh Dur Bond ETF
FSB.U.TO	CI First Asset Enhanced Sh Dur Bond ETF USD
FSF.TO	CI First Asset Global Financial Sector ETF
FSL.TO	First Trust Senior Loan ETF
FSL.A.TO	First Trust Senior Loan ETF Adv Cls
FSR.TO	First Trust DW US Sctr Rtn ETF
FST.TO	First Trust CDN Capital Strength ETF
FST.A.TO	First Trust CDN Capital Strength ETF AC
FSV.TO	Firstservice Corp
FSY.TO	Forsys Metals Corp
FSZ.TO	Fiera Capital Corp
FSZ.DB.TO	Fiera Capital Corp 5.0 Pct Debs
FSZ.DB.A.TO	Fiera Capital Corp 5.60 Pct Debs
FT.TO	Fortune Mnrl J
FTB.TO	First Trust Tactical Bond Index ETF
FTG.TO	Firan Technology Group Corp
FTN.TO	Financial 15 Split Corp
FTN.PR.A.TO	Financial 15 Split Corp
FTS.TO	Fortis Inc
FTS.PR.F.TO	Fortis Inc Pref Shares Series F
FTS.PR.G.TO	Fortis Inc First Pref Ser G
FTS.PR.H.TO	Fortis Inc Pref Ser H
FTS.PR.I.TO	Fortis Inc Pref Ser I
FTS.PR.J.TO	Fortis Inc Pref Ser J
FTS.PR.K.TO	Fortis Inc Pref Ser K
FTS.PR.M.TO	Fortis Inc Pref Ser M
FTT.TO	Finning Intl
FTU.TO	US Financial 15 Split Corp
FTU.PR.B.TO	US Finl 15 Split 2012 Pref Sh
FUD.TO	First Trust Alphadex US Div ETF CAD Hdg
FUD.A.TO	First Trust Value Line Div Idx ETF AC
FURY.TO	Fury Gold Mines Limited
FVI.TO	Fortuna Silver Mines Inc
FVI.DB.U.TO	Fortuna Silver Mines Inc 4.65 Pct Debs
FVL.TO	Freegold Ventures Limited
FXC.TO	Fax Capital Corp
FXC.WT.TO	Fax Capital Corp Wts
FXM.TO	CI First Asset Morningstar Cda Value ETF
GATO.TO	Gatos Silver Inc
GAU.TO	Galiano Gold Inc
GBAL.TO	Ishares ESG Balanced ETF
GBT.TO	Bmtc Group Inc
GC.TO	Great Canadian Gaming Corp
GC.DB.TO	Great Canadian Gaming Corp 5.25 Pct Debs
GCG.TO	Guardian Capital
GCG.A.TO	Guardian Capital Group Ltd Cl.A NV
GCL.TO	Colabor Group Inc
GCL.DB.A.TO	Colabor Group Inc 6.0 Pct Debs
GCM.TO	Gran Colombia Gold Corp
GCM.NT.U.TO	Gran Colombia Gold 5.0 Pct Sil Notes
GCM.WT.B.TO	Gran Colombia Gold Corp WT B
GCNS.TO	Ishares ESG Conservative Balanced ETF
GCT.C.TO	Gvic Communications Corp N.V. Class C
GDC.TO	Genesis Land J
GDEP.TO	Guardian Directed Equity Path ETF
GDEP.B.TO	Guardian Directed Equity Path ETF Unhdg
GDG.UN.TO	Global Dividend Growers Income Fund
GDI.TO	Gdi Integrated Facility Services Inc
GDL.TO	Goodfellow Inc
GDPY.TO	Guardian Directed Premium Yield ETF
GDPY.B.TO	Guardian Directed Premium Yield ETF Uh
GDV.TO	Global Dividend Growth Split Corp
GDV.PR.A.TO	Global Dividend Growth Split Corp Pref A
GEC.UN.TO	Global Real Estate & E-Commerce Dividend
GEI.TO	Gibson Energy Inc
GEI.DB.TO	Gibson Energy Inc 5.25 Pct Debs
GENM.TO	Generation Mining Limited
GEO.TO	Geodrill Limited
GEQT.TO	Ishares ESG Equity ETF
GFL.TO	Gfl Environmental Inc
GGA.TO	Goldgroup Mining Inc
GGD.TO	Gogold Resources Inc
GGRO.TO	Ishares ESG Growth ETF
GH.TO	Gamehost Inc
GIB.A.TO	CGI Group Inc Cl.A Sv
GIGR.TO	Guardian I3 Global REIT ETF (Hedged Unit
GIGR.B.TO	Guardian I3 Global REIT ETF (Unhedged Un
GIL.TO	Gildan Activewear Inc
GIQG.TO	Guardian I3 Global Quality Growth ETF
GIQG.B.TO	Guardian I3 Global Quality Growth ETF Uh
GIQU.TO	Guardian I3 US Quality Growth ETF ( Hedg
GIQU.B.TO	Guardian I3 US Quality Growth ETF (Unhed
GLG.TO	Glg Life Tech Corp
GLO.TO	Global Atomic Corp
GLXY.TO	Galaxy Digital Holdings Ltd
GMP.TO	Gmp Capital Inc
GMP.PR.B.TO	Gmp Capital Inc Series B Pref
GMX.TO	Globex Mining Enterprises Inc
GOLD.TO	Goldmining Inc
GOOS.TO	Canada Goose Holdings Inc
GPR.TO	Great Panther Silver Limited
GRC.TO	Gold Springs Resource Corp
GRT.UN.TO	Granite Real Estate Investment Trust
GSC.TO	Golden Star
GSV.TO	Gold Standard Ventures Corp
GSY.TO	Goeasy Ltd
GTE.TO	Gran Tierra Energy Inc
GTMS.TO	Greenbrook Tms Inc
GUD.TO	Knight Therapeutics Inc
GURU.TO	Guru Organic Energy Corp
GVC.TO	Glacier Media Inc
GWO.TO	Great-West Lifeco Inc
GWO.PR.F.TO	Great-West Lifeco Inc
GWO.PR.G.TO	Great-West Lifeco Inc Pr. G
GWO.PR.H.TO	Great-West Lifeco Inc 4.85 % Pr.Ser H
GWO.PR.I.TO	Great-West Lifeco Inc Prf Series I
GWO.PR.L.TO	Great-West Lifeco Inc Pref Ser L
GWO.PR.M.TO	Great West Lifeco Pref Ser M
GWO.PR.N.TO	Great West Lifeco Inc Pref Srs N
GWO.PR.O.TO	Great West Lifeco Pref Ser O
GWO.PR.P.TO	Great West Lifeco Inc 5.4 Pct Pref Sh
GWO.PR.Q.TO	Great West Lifeco Pref Ser Q
GWO.PR.R.TO	Great West Lifeco Inc Ser R
GWO.PR.S.TO	Great West Lifeco Pref Ser S
GWO.PR.T.TO	Great West Lifeco Pref Ser T
GWR.TO	Global Water Resources Inc
GXE.TO	Gear Energy Ltd
H.TO	Hydro One Limited
HAB.TO	Horizons Active Corporate Bond ETF
HAC.TO	Horizons Seasonal Rotation ETF
HAD.TO	Horizons Active CDN Bond ETF
HAF.TO	Horizons Active Global Fixed Income ETF
HAI.TO	Haivision Systems Inc
HAJ.TO	Horizons Active Emerging Mkts Div ETF
HAL.TO	Horizons Active CDN Dividend ETF
HARB.TO	Horizons Tactical Absolute Rtrn Bnd ETF
HARC.TO	Horizons Abs Return Global Currency ETF
HAU.TO	Horizons Active US Dividend ETF
HAZ.TO	Horizons Active Global Dividend ETF
HBA.TO	Hamilton Australian Banks Equal-Weight ETF
HBAL.TO	Horizons Balanced Tri ETF
HBB.TO	Horizons CDN Select Universe Bond ETF
HBD.TO	Betapro Gold Bullion 2X Daily Bear ETF
HBF.TO	Harvest Brand Leaders Plus Income ETF
HBF.B.TO	Harvest Brand Leaders Plus Inc ETF Unh
HBF.U.TO	Harvest Brand Leaders Plus Income ETF USD
HBGD.TO	Horizons Big Data Hardware Idx ETF
HBGD.U.TO	Horizons Big Data Hardware Idx ETF USD
HBL.UN.TO	Brand Leaders Income Fund
HBLK.TO	Blockchain Technologies ETF
HBM.TO	Hudbay Minerals Inc
HBP.TO	Helix Biopharm
HBU.TO	Betapro Gold Bullion 2X Daily Bull ETF
HCA.TO	Hamilton Canadian Bank Mean Reversion ETF
HCAL.TO	Hamilton Canadian Bank 1.25X Lvrg ETF
HCG.TO	Home Capital Group Inc
HCN.TO	Horizons China High Dividend Yield ETF
HCON.TO	Horizons Conservative Tri ETF
HCRE.TO	Horizons Eql Wght Can REIT Index ETF
HDGE.TO	Accelerate Absolute Return Hdg Fund ETF
HDI.TO	Hardwoods Distribution Inc
HE.TO	Hanwei Energy Services Corp
HEA.TO	Horizons Enhd Income US Equity ETF
HEA.U.TO	Horizons Enhd Income US Equity USD ETF
HED.TO	Betapro S&P TSX Cap Engy 2X Dly Bear ETF
HEE.TO	Horizons Enhanced Income Energy ETF
HEF.TO	Horizons Enhanced Income Fin ETF
HEJ.TO	Horizons Enhd Inc Intl Equity ETF
HEMB.TO	Horizons Active Emerging Mkts Bond ETF
HEP.TO	Horizons Enhanced Income Gold Prod ETF
HERO.TO	Evolve E Gaming Index ETF
HEU.TO	Betapro S&P TSX Cap Engy 2X Dly Bull ETF
HEWB.TO	Horizons Eql Wght Can Banks Index ETF
HEX.TO	Horizons Enhanced Income Equity ETF
HEXO.TO	Hexo Corp
HFD.TO	Betapro S&P TSX Cap Fncl 2X Dly Bear ETF
HFG.TO	Hamilton Global Financials ETF
HFP.TO	Horizons Active Flt Rate Pref ETF
HFPC.U.TO	Helios Fairfax Partners Corporation
HFR.TO	Horizons Active Floating Rate Bond ETF
HFT.TO	Hamilton Financials Innovation ETF
HFU.TO	Betapro S&P TSX Cap Fncl 2X Dly Bull ETF
HGD.TO	Betapro CDN Gold Miners 2X Dly Bear ETF
HGGG.TO	Harvest Global Gold Giants Index ETF
HGI.UN.TO	Global Telecom and Utilities IN Fd
HGM.TO	Horizons Managed Global Oppt ETF
HGR.TO	Harvest Global REIT Leaders Income ETF
HGRO.TO	Horizons Growth Tri ETF
HGU.TO	Betapro CDN Gold Miners 2X Dly Bull ETF
HGY.TO	Horizons Gold Yield ETF
HHF.TO	Horizons Morningstar Hdg Fd ETF
HHL.TO	Harvest Healthcare Leaders Income ETF
HHL.B.TO	Harvest Healthcare Leaders Inc ETF Unh
HHL.U.TO	Harvest Healthcare Leaders Income ETF USD
HIG.TO	Brompton Global Healthcare Inc & Gth ETF
HII.TO	Horizons CDN Insider Index ETF
HIU.TO	Betapro Sp500 Daily Inverse ETF
HIX.TO	Betapro S&P TSX 60 Daily Inverse ETF
HLF.TO	High Liner
HLPR.TO	Horizons Laddered CDN Pref Index ETF
HLS.TO	Hls Therapeutics Inc
HMJI.TO	Betapro Marijuana Cos Inverse ETF
HMJU.TO	Betapro Marijuana Cos 2X Daily Bull ETF
HMM.A.TO	Hammond Manufacturing Co. Ltd Cl A. Sv
HMMJ.TO	Horizons Marijuana Life Sciences ETF
HMMJ.U.TO	Horizons Marijuana Life Sciences Idx USD
HMP.TO	Horizons Active CDN Municipal Bond ETF
HND.TO	Betapro Nat Gas 2X Daily Bear ETF
HNU.TO	Betapro Nat Gas 2X Daily Bull ETF
HNY.TO	Horizons Natural Gas Yield ETF
HOD.TO	Betapro Crude Oil 2X Daily Bear ETF
HOG.TO	Horizons CDN Midstream Oil Gas ETF
HOM.DB.U.TO	Bsr REIT 5.0 Pct Debs USD
HOM.U.TO	Bsr Real Estate Investment Trust
HOM.UN.TO	Bsr Real Estate Investment Trust
HOT.DB.U.TO	American Hotel Inc Prop REIT 5 Pct Debs
HOT.U.TO	American Hotel Income Properties REIT US
HOT.UN.TO	American Hotel Income Properties REIT LP
HOU.TO	Betapro Crude Oil 2X Daily Bull ETF
HPF.TO	Harvest Energy Leaders Plus Income ETF
HPF.U.TO	Harvest Energy Leaders Plus Income ETF USD
HPR.TO	Horizons Active Pref Share ETF
HPS.A.TO	Hammond Power Solutions Inc Cl A. Sv
HQD.TO	Betapro Nasdaq 100 2X Daily Bear ETF
HQD.U.TO	Betapro Nasdaq 100 2X Daily Bear ETF USD
HQU.TO	Betapro Nasdaq 100 2X Daily Bull ETF
HR.UN.TO	H&R Real Estate Inv Trust
HRAA.TO	Horizons Resolve Adptv Asset Alloc ETF
HRR.UN.TO	Australian REIT Income Fund
HRT.TO	Harte Gold Corp
HRX.TO	Heroux-Devtek
HSAV.TO	Horizons Cash Maximizer ETF
HSD.TO	Betapro Sp500 2X Daily Bear ETF
HSE.TO	Husky Energy Inc
HSE.PR.A.TO	Husky Energy Inc Pref Ser 1
HSE.PR.B.TO	Husky Energy Inc Pref Ser 2
HSE.PR.C.TO	Husky Energy Inc Pref Ser 3
HSE.PR.E.TO	Husky Energy Inc Pref Ser 5
HSE.PR.G.TO	Husky Energy Inc Pref Ser 7
HSH.TO	Horizons Sp500 CAD Hedged Index ETF
HSL.TO	Horizons Active Float Rate Sen Loan ETF
HSM.TO	Helius Medical Technologies Inc
HSU.TO	Betapro Sp500 2X Daily Bull ETF
HSUV.U.TO	Horizons USD Cash Maximizer ETF USD
HTA.TO	Harvest Tech Achievers Growth & Income ETF
HTA.B.TO	Harvest Tech Achievers Grwth Inc ETF Unh
HTA.U.TO	Harvest Tech Achievers Growth & Income ETF USD
HTB.TO	Horizons US 7 To 10 Yr Treasury Bond ETF
HTB.U.TO	Horizons US 7 To 10 Yr Treas Bd ETF USD
HTH.TO	Horizons US 7 10 Yr Treas Bd CAD Heg ETF
HUBL.TO	Harvest US Bank Leaders Income ETF
HUBL.U.TO	Harvest US Bank Leaders Income ETF USD
HUC.TO	Horizons Crude Oil ETF
HUF.TO	Horizons Active US Float Rate Bd ETF CAD
HUF.U.TO	Horizons Active US Floating Rate Bd ETF
HUG.TO	Horizons Gold ETF
HUIB.TO	Harvest US Investment Grade Bnd Plus ETF
HUL.TO	Harvest US Equity Plus Income ETF
HUL.U.TO	Harvest US Equity Plus Income ETF USD
HULC.TO	Horizons US Large Cap Index ETF
HULC.U.TO	Horizons US Large Cap Index ETF USD
HUM.TO	Hamilton U.S. Mid/Small-Cap Financials E
HUM.U.TO	Hamilton US Mid Small Cap Fincls ETF USD
HUN.TO	Horizons Natural Gas ETF
HURA.TO	Horizons Global Uranium Index ETF
HUT.TO	Hut 8 Mining Corp
HUT.WT.TO	Hut 8 Mining Corp Wts
HUTL.TO	Harvest Eql Wght Glb Util Income ETF
HUV.TO	Betapro Sp500 VIX ST Ftrs ETF
HUZ.TO	Horizons Silver ETF
HWF.TO	Middlefield Health Wellness ETF
HWO.TO	High Arctic Energy Services Inc
HWX.TO	Headwater Exploration Inc
HXCN.TO	Horizons SP TSX Capped Comp Index ETF
HXD.TO	Betapro S&P TSX 60 2X Daily Bear ETF
HXDM.TO	Horizons Intl Dev Mkts Equity Index ETF
HXDM.U.TO	Horizons Intl Dev Mkts Eqty Idx USD ETF
HXE.TO	Horizons S&P TSX Capped Energy Index ETF
HXEM.TO	Horizons Emerging Mkts Equity Index ETF
HXF.TO	Horizons S&P TSX Capped Fncl Index ETF
HXH.TO	Horizons CDN High Dividend Index ETF
HXQ.TO	Horizons Nasdaq 100 Index ETF
HXQ.U.TO	Horizons Nasdaq 100 Index ETF USD
HXS.TO	Horizons S&P 500 Index ETF
HXS.U.TO	Horizons S&P 500 Index ETF USD
HXT.TO	Horizons S&P Tsx60 Index ETF
HXT.U.TO	Horizons S&P TSX 60 Index ETF USD
HXU.TO	Betapro S&P TSX 60 2X Daily Bull ETF
HXX.TO	Horizons Euro Stoxx 50 Index ETF
HYI.TO	Horizons Active High Yield Bond ETF
HZD.TO	Betapro Silver 2X Daily Bear ETF
HZM.TO	Horizonte Minerals Plc
HZU.TO	Betapro Silver 2X Daily Bull ETF
IAF.PR.B.TO	Industrial Alliance Cl A Pref Ser B
IAF.PR.G.TO	Industrial Alliance Cl A Pref Ser G
IAF.PR.I.TO	Industrial Alliance Cl A Pref Ser I
IAG.TO	Industrial Alliance Ins & Fin Srv Inc
IBG.TO	Ibi Group Inc
IBG.DB.D.TO	Ibi Group Inc 5.50 Pct Debs
IBG.DB.E.TO	Ibi Group Inc. 6.50% Listed Senior
ICE.TO	Canlan ICE Sports Corp
ICPB.TO	IA Clarington Core Plus Bond Fund
IDG.TO	Indigo Books & Music Inc
IDR.TO	Middlefield REIT Indexplus ETF
IFA.TO	Ifabric Corp
IFC.TO	Intact Financial Corp
IFC.PR.A.TO	Intact Financial Corp Pref Cl A
IFC.PR.C.TO	Intact Financial Corp Pref Cl A
IFC.PR.D.TO	Intact Financial Corp Pref Shares Ser 4
IFC.PR.E.TO	Intact Financial Corp Pref Cl A Ser 5
IFC.PR.F.TO	Intact Financial Corp Pref Shares Ser 6
IFC.PR.G.TO	Intact Financial Corp Pref Shares Ser 7
IFC.PR.I.TO	Intact Financial Corp Pref Shares Ser 9
IFP.TO	Interfor Corp
IFRF.TO	IA Clarington Floating Rate Income ETF
IGAF.TO	IA Clarington Global Allocation Fund ETF
IGB.TO	Purpose Mngd Duration Invest Bond ETF
IGCF.TO	Pimco Investment Grade Credit Fund
IGLB.TO	IA Clarington Global Bond Fund
IGM.TO	Igm Financial Inc
III.TO	Imperial Metals Corp
IIP.UN.TO	Interrent Real Estate Investment Trust
ILV.TO	Invesco SP Intl Dev Low Vol Idx ETF
ILV.F.TO	Invesco SP Intl Dev Low Vol ETF Hedged
IMG.TO	Iamgold Corp
IMO.TO	Imperial Oil
IMP.TO	Intermap Tech Corp
IMV.TO	Imv Inc.
IN.TO	Inmed Pharmaceuticals IN
INC.UN.TO	Income Fin Un
INE.TO	Innergex Renewable Energy Inc
INE.DB.B.TO	Innergex Renewable Energy 4.75 Pct Debs
INE.DB.C.TO	Innergex Renewable Energy 4.65 Pct Debs
INE.PR.A.TO	Innergex Renewable Energy Pref Ser A
INE.PR.C.TO	Innergex Renewable Energy Inc Pref Ser C
INF.UN.TO	Sustainable Infrastructure Div Fund
INO.UN.TO	Inovalis REIT
INOC.TO	Horizons Inovestor CDN Equity Index ETF
INQ.TO	Inscape Corp Sv
INV.TO	Inv Metals Inc
IPCI.TO	Intellipharmaceutics International Inc
IPCO.TO	International Petroleum Corp
IPL.TO	Inter Pipeline Ltd
IPO.TO	Inplay Oil Corp
IQD.TO	CI Wisdomtree Intl Qlty Divd Growth Index ETF
IQD.B.TO	CI Wisdomtree Intl Qlty Divd Growth Index ETF
ISV.TO	Information Services Corp
ITE.TO	I3 Energy Plc
ITH.TO	International Tower Hill Mines Ltd
ITP.TO	Intertape Polymer
IVN.TO	Ivanhoe Mines Ltd
IVQ.TO	Invesque Inc CAD
IVQ.DB.U.TO	Invesque Inc 5.00 Pct Debs
IVQ.DB.V.TO	Invesque Inc 6.00 Pct Debs USD
IVQ.U.TO	Invesque Inc
JAG.TO	Jaguar Mining Inc
JAPN.TO	CI Wisdomtree Japan Equity Index ETF
JAPN.B.TO	CI Wisdomtree Japan Equity Index ETF
JE.TO	Just Energy Group Inc
JFS.UN.TO	Jft Strategies Fund
JOSE.TO	Josemaria Resources Inc
JOY.TO	Journey Energy Inc
JWEL.TO	Jamieson Wellness Inc
K.TO	Kinross Gold Corp
KBL.TO	Kbro Linen Inc
KEG.UN.TO	Keg Royalties Income Fund
KEI.TO	Kolibri Global Energy Inc
KEL.TO	Kelt Exploration Ltd
KER.TO	Kerr Mines Inc
KEY.TO	Keyera Corp
KILO.TO	Purp Gold Bullion Tu
KILO.B.TO	Purpose Gold Bullion Fund Non Hedged
KILO.U.TO	Purpose Gold Bullion Fund Non Hedged USD
KL.TO	Kirkland Lake Gold Ltd
KLS.TO	Kelso Technologies Inc
KMP.UN.TO	Killam Apartment REIT
KNT.TO	K92 Mining Inc
KOR.TO	Corvus Gold Inc
KPT.TO	Kp Tissue Inc
KRN.TO	Karnalyte Resources Inc
KRR.TO	Karora Resources Inc.
KRR.WT.TO	Karora Resources Inc Wts
KXS.TO	Kinaxis Inc
L.TO	Loblaw CO
L.PR.B.TO	Loblaw Companies Ltd 2nd Pref Ser B
LABS.TO	Medipharm Labs Corp
LAC.TO	Lithium Americas Corp
LAM.TO	Laramide Resources Ltd
LAS.A.TO	Lassonde Industries Inc Cl A Sv
LB.TO	Laurentian Bank
LB.PR.H.TO	Laurentian Bank of Cda Pr Ser 13
LB.PR.J.TO	Laurentian Bank of Cda Pr Ser 15
LBS.TO	Life & Banc Split Corp
LBS.PR.A.TO	Life & Banc Split Corp
LCS.TO	Brompton Lifeco Split Corp Class A
LCS.PR.A.TO	Brompton Lifeco Split Corp Pref Shares
LEAD.TO	Evolve Future Leadership ETF Hedged
LEAD.B.TO	Evolve Future Leadership ETF Unhedged
LEAD.U.TO	Evolve Future Leadership ETF Uh USD
LFE.TO	Canadian Life Companies Split Corp
LFE.PR.B.TO	Canadian Life Split 2012 Pref Sh
LGD.TO	Liberty Gold Corp
LGO.TO	Largo Resources Ltd
LGT.A.TO	Logistec Corporation Cl.A Mv
LGT.B.TO	Logistec Corporation Cl.B Sv
LIF.TO	Labrador Iron Ore Royalty Corp
LIFE.TO	Evolve Global Healthcare Enhance Yld ETF
LIFE.B.TO	Evolve Global Healthcare Enhance Yld Unheg
LIFE.U.TO	Evolve Global Healthcare Yld Fund ETF USD
LN.TO	Loncor Resources Inc
LNF.TO	Leons Furniture
LNR.TO	Linamar Corp
LONG.TO	CI Global Longevity Economy Fund ETF
LS.TO	Middlefield Healthcare Life Sciences ETF
LSPD.TO	Lightspeed Pos Inc
LUC.TO	Lucara Diamond Corp
LUG.TO	Lundin Gold Inc
LUN.TO	Lundin Mining Corp
LXR.TO	Lxrandco Inc
LXR.WT.TO	Lxrandco Inc WT
MAG.TO	MAG Silver Corp
MAL.TO	Magellan Aero
MARI.TO	Marimaca Copper Corp
MAV.TO	Mav Beauty Brands Inc
MAW.TO	Mawson Resources Ltd
MAX.TO	Midas Gold Inc
MAXR.TO	Maxar Technologies Inc
MAYB.F.TO	First Trust CBOE Vst US Eq Bf Hg ETF May
MBA.TO	Cibt Education Group Inc
MBAL.TO	Mackenzie Balanced Allocation ETF
MBN.TO	Mbn Corp
MBX.TO	Microbix J
MCB.TO	Mccoy Global Inc
MCLC.TO	Manulife Mltfactor CDN Large Cap Uh ETF
MCON.TO	Mackenzie Conservative Allocation CAD ETF
MCSB.TO	Mackenzie CDN Short Term Fixed Inc ETF
MCSM.TO	Manulife Mulfact CDN Smid Cap Idx ETF
MDC.UN.TO	Digital Consumer Dividend Fund
MDF.TO	Mdf Commerce Inc.
MDI.TO	Major Drilling Grp
MDNA.TO	Medicenna Therapeutics Corp
MDS.UN.TO	Healthcare Special Opp Fund
MDVD.TO	Mackenzie Global Sustainable Div Idx ETF
ME.TO	Moneta Porcupine J
MEE.TO	Mackenzie Max Diverse Emg Mkts ETF
MEG.TO	Meg Energy Corp
MEME.B.TO	Manulife Multifactor Emerg Mkts Idx ETF
MEQ.TO	Mainstreet Eq J
MEU.TO	Mackenzie Max Diversif Dev EUR ETF
MFC.TO	Manulife Fin
MFC.PR.B.TO	Manulife Financial Cl A Pref Ser 2
MFC.PR.C.TO	Manulife Financial Cl A Pref Ser 3
MFC.PR.F.TO	Manulife Financial Cl 1 Sh Ser 3
MFC.PR.G.TO	Manulife Financial Non Cum Cla 1 Ser 5
MFC.PR.H.TO	Manulife Financial Pref Ser 7
MFC.PR.I.TO	Manulife Financial Pref Ser 9
MFC.PR.J.TO	Manulife Financial Class 1 Ser 11
MFC.PR.K.TO	Manulife Financial Pref Ser 13
MFC.PR.L.TO	Manulife Financial Pref Ser 15
MFC.PR.M.TO	Manulife Financial Pref Ser 17
MFC.PR.N.TO	Manulife Financial Pref Ser 19
MFC.PR.O.TO	Manulife Financial Pref Ser 21
MFC.PR.P.TO	Manulife Financial Class 1 Sh Ser 4
MFC.PR.Q.TO	Manulife Financial Corp Pref Series 25
MFC.PR.R.TO	Manulife Financial Pref Ser 23
MFI.TO	Maple Leaf Foods
MFT.TO	Mackenzie Floating Rate Income ETF
MG.TO	Magna International Inc
MGA.TO	Mega Uranium Ltd
MGAB.TO	Mackenzie Global Fixed Income Alloc ETF
MGB.TO	Mackenzie Core Pls Glob Fixed Inc ETF
MGRW.TO	Mackenzie Growth Allocation ETF
MHC.U.TO	Flagship Communities Real Estate Investm
MI.UN.TO	Minto Apartment REIT
MIC.TO	Genworth MI Canada Inc
MID.UN.TO	Mint Income Fund
MIN.TO	Excelsior Mining Corp
MIND.TO	Horizons Active Ai Global Equity ETF
MINT.TO	Manulife Mltfactor Dev Intl Hgd ETF
MINT.B.TO	Manulife Mltfactor Dev Intl Uh ETF
MIVG.TO	Mackenzie Ivy Global Equity ETF
MKB.TO	Mackenzie Core Pls CDN Fixed Income ETF
MKC.TO	Mackenzie Max Dvrs Cda Index ETF
MKP.TO	Mcan Mortgage Corp
MKZ.UN.TO	Mackenzie Mstr Un
MMP.UN.TO	Precious Metals and Mining Trust
MMX.TO	Maverix Metals Inc
MND.TO	Mandalay Resources Corp
MNS.TO	Royal CDN Mint CDN Silver Reserves Etr
MNS.U.TO	Royal CDN Mint CDN Svr Reserves Etr USD
MNT.TO	Royal Canadian Mint CDN Gold Reserves
MNT.U.TO	Royal Canadian Mint CDN Gld Reserves USD
MOGO.TO	Mogo Inc
MOGO.DB.TO	Mogo Inc 10.0 Pct Debs
MOGO.WT.TO	Mogo Inc Wts
MOZ.TO	Marathon Gold Corp
MPC.TO	Madison Pac Cl B
MPC.C.TO	Madison Pacific Properties Inc Cl.C NV
MPCF.TO	Mackenzie Portfolio Completion ETF
MPCT.UN.TO	Dream Impact Trust Units
MPVD.TO	Mountain Province Diamonds Inc
MQR.TO	Monarques Gold Corp
MR.DB.A.TO	Melcor REIT 5.25 Pct Debs
MR.DB.B.TO	Melcor REIT 5.1 Pct Debs
MR.UN.TO	Melcor REIT
MRC.TO	Morguard Corp
MRD.TO	Melcor Dev
MRE.TO	Martinrea International Inc
MRG.DB.A.TO	Morguard Na REIT 4.50 Pct Debs
MRG.UN.TO	Morguard Na Residential REIT Units
MRT.DB.TO	Morguard REIT 4.50 Pct Debs
MRT.UN.TO	Morguard Un
MRU.TO	Metro Inc
MSI.TO	Morneau Shepell Inc
MSV.TO	Minco Silver Corp
MTL.TO	Mullen Group Ltd
MTL.DB.TO	Mullen Group Ltd 5.75 Pct Debs
MTY.TO	Mty Food Group Inc
MUB.TO	Mackenzie Unconstrained Bond ETF
MULC.TO	Manulife Mltfactor US Large Cap Hgd ETF
MULC.B.TO	Manulife Mltfactor US Large Cap Uh ETF
MUMC.TO	Manulife Mltfactor US Mid Cap Hgd ETF
MUMC.B.TO	Manulife Mltfactor US Mid Cap Uh ETF
MUS.TO	Mackenzie Max Dvrs US Index ETF
MUSC.TO	Manulife Multifactor U.S. Small Cap Index ETF
MUSC.B.TO	Manulife Mulfact US Scap Idx ETF Unheg
MUX.TO	Mcewen Mining Inc
MWD.TO	Mackenzie Max Diversif World Dev ETF
MX.TO	Methanex Corp
MXG.TO	Maxim Power Corp
MXU.TO	Mackenzie Max Divers Wrld Dev Ex Na ETF
NA.TO	National Bank of Canada
NA.PR.A.TO	National Bank Pref Ser 36
NA.PR.C.TO	National Bank Pref Ser 38
NA.PR.E.TO	National Bank Pref Series 40
NA.PR.G.TO	National Bank Pref Series 42
NA.PR.S.TO	National Bank Pref Ser 30
NA.PR.W.TO	National Bank Pref Ser 32
NA.PR.X.TO	National Bank Pref Ser 34
NAC.U.TO	Nextpoint Acquisition Corp USD
NAC.WT.U.TO	Nextpoint Acquisition Corp USD Wts
NALT.TO	Nbi Liquid Alternatives ETF
NB.TO	Niocorp Developments Ltd
NCF.TO	Northcliff Resources Ltd
NCG.TO	Ncm Core Global ETF
NCM.TO	Newcrest Mining Limited
NCP.TO	Nickel Creek Platinum Corp
NCU.TO	Nevada Copper Corp
NCU.WT.TO	Nevada Copper Corp.
NDM.TO	Northern Dynasty Minerals Ltd
NDM.WT.B.TO	Northern Dynasty Minerals Ltd WT B
NEO.TO	NEO Performance Materials Inc
NEPT.TO	Neptune Wellness Solutions Inc
NEXA.TO	Nexa Resources S.A.
NEXT.TO	Nextsource Materials Inc
NFAM.TO	Nbi Canadian Family Business ETF
NFI.TO	New Flyer Industries Inc
NG.TO	Novagold Res Inc
NGD.TO	New Gold Inc
NGPE.TO	Nbi Global Private Equity ETF
NGT.TO	Newmont Corp.
NHF.UN.TO	Northview CDN High Yld Residential Fund
NHK.TO	Nighthawk Gold Corp
NHYB.TO	Nbi High Yield Bond ETF
NIF.UN.TO	Noranda Income Fund
NML.TO	New Millennium Iron Corp
NOA.TO	North American Construction Group Ltd.
NOA.DB.A.TO	Na Construction Grp Ltd 500% Conv. Unsec. Sub DE
NOVB.F.TO	FT CBOE Vest US Eqty Buffer November ETF
NPI.TO	Northland Power Inc
NPI.PR.A.TO	Northland Power Pref Equity Inc
NPI.PR.B.TO	Northland Power Inc Pref Ser 2
NPI.PR.C.TO	Northland Power Inc Pref Ser 3
NPK.TO	Verde Agritech Plc
NPRF.TO	Nbi Active Canadian Preferred Sh ETF
NREA.TO	Nbi Global Real Assets Income ETF
NRI.TO	Nuvo Pharmaceuticals Inc
NSCB.TO	Nbi Sustainable Canadian Bond ETF
NSCE.TO	Nbi Sustainable Canadian Equity ETF
NSGE.TO	Nbi Sustainable Global Equity ETF
NSR.TO	Nomad Royalty Company Ltd.
NSR.WT.TO	Nomad Royalty Company Ltd Wts
NTR.TO	Nutrien Ltd
NUAG.TO	New Pacific Metals Corp
NUBF.TO	Nbi Unconstrained Fixed Income ETF
NVA.TO	Nuvista Energy Ltd
NVCN.TO	Neovasc Inc
NVEI.TO	Nuvei Corporation
NVEI.U.TO	Nuvei Corporation USD
NWC.TO	The North West Company Inc
NWH.DB.E.TO	Northwest Healthcare Prop 5.25 Pct Debs
NWH.DB.F.TO	Northwest Healthcare Prop 5.25 Pct Debs
NWH.DB.G.TO	Northwest Healthcare Prop REIT 5.50 Debs
NWH.UN.TO	Northwest Healthcare Prop REIT
NXE.TO	Nexgen Energy Ltd
NXF.TO	CI First Asset Energy Giants Cov Call ETF
NXF.B.TO	CI First Asset Energy Giants ETF Unhedged
NXJ.TO	Nexj Systems Inc
NZC.TO	Norzinc Ltd
OBE.TO	Obsidian Energy Ltd
OGC.TO	Oceanagold Corp
OGD.TO	Orbit Garant Drilling Inc
OGI.TO	Organigram Holdings Inc
OLA.TO	Orla Mining Ltd
OLY.TO	Olympia Financial Group Inc
OMI.TO	Orosur Mining Inc
ONC.TO	Oncolytics Bio
ONC.WT.TO	Oncolytics Biotech Inc WT
ONEB.TO	CI One North American Core Plus Bond ETF
ONEQ.TO	CI One Global Equity ETF
ONEX.TO	Onex Corp
OPS.TO	Opsens Inc
OPT.TO	Optiva Inc
OR.TO	Osisko Gold Royalties Ltd
OR.DB.TO	Osisko Gold Royalties Ltd 4.00 Pct Debs
OR.WT.TO	Osisko Gold Royalties Ltd WT
ORA.TO	Aura Minerals Inc
OREA.TO	Orea Mining Corp
ORL.TO	Orocobre Limited
ORV.TO	Orvana Minerals J
OSB.TO	Norbord Inc
OSK.TO	Osisko Mining Inc
OSP.TO	Brompton Oil Split Corp
OSP.PR.A.TO	Brompton Oil Split Corp Pref
OTEX.TO	Open Text Corp
OVV.TO	Ovintiv Inc
OXC.TO	Oryx Petroleum Corporation Ltd
PAAS.TO	Pan American Silver Corp
PAT.TO	Patriot One Technologies Inc
PAT.WT.B.TO	Patriot One Technologies Inc WT B
PATH.TO	Counterpath Corp
PAYF.TO	Purpose Enhanced Premium Yield Fund ETF
PBD.TO	Purpose Total Return Bond Fund ETF
PBH.TO	Premium Brands Holdings Corp
PBH.DB.F.TO	Premium Brands Hld Corp 4.60 Pct Debs
PBH.DB.G.TO	Premium Brands Holdings 4.65 Pct Debs
PBH.DB.H.TO	Premium Brands Holdings 4.20 Pct Debs
PBI.TO	Purpose Best Ideas Fund ETF
PBI.B.TO	Purpose Best Ideas Fund Non Hdg
PBL.TO	Pollard Banknote Limited
PBY.UN.TO	Canso Credit Income Fund Units
PCOR.TO	Pimco Managed Core Bond Pool ETF
PD.TO	Precision Drilling Corp
PDC.TO	Invesco CDN Div Idx ETF
PDF.TO	Purpose Core Dividend Fund ETF
PDIV.TO	Purpose Enhanced Dividend Fund ETF
PDV.TO	Prime Dividend Corp Cl A
PDV.PR.A.TO	Prime Dividend Corp Pref
PEA.TO	Pieridae Energy Ltd
PEY.TO	Peyto Exploration and Dvlpmnt Corp
PFAE.TO	Picton Mahoney Fort Act Ext Alt Fund ETF
PFB.TO	Pfb Corp
PFH.F.TO	Invesco HY Corp Bond Index ETF
PFIA.TO	Picton Mahoney Fort Income Alt Fund ETF
PFL.TO	Powershares 1 To 3 Yr Lad Float Rate ETF
PFLS.TO	Picton Mahoney Frt Lng Shrt Alt Fund ETF
PFMN.TO	Picton Mahoney Fort Mkt Neutral Fund ETF
PFMS.TO	Picton Mahoney Multi Strat Alt Fund ETF
PG.TO	Premier Gold Mines Ltd
PGI.UN.TO	Pimco Global Inc Opportunities Fund
PHE.TO	Purpose Tactical Hedged Equity Fund ETF
PHE.B.TO	Purpose Tactical Hedged Equity Fund ETF
PHO.TO	Photon Control Inc
PHR.TO	Purpose Duration Hedged Real Estate ETF
PHW.TO	Purpose Intl Tactical Hedged Equity ETF
PHX.TO	Phx Energy Services Corp
PHYS.TO	Sprott Physical Gold Trust CAD
PHYS.U.TO	Sprott Physical Gold Trust USD
PIC.A.TO	Premium Income A
PIC.PR.A.TO	Premium Income Pr
PID.TO	Purpose Intl Dividend Fund ETF
PIF.TO	Polaris Infrastructure Inc
PIF.DB.TO	Polaris Infrastructure 7.0 Pct Debs
PIN.TO	Purpose Monthly Income Fund ETF
PINC.TO	Purpose Multi Asset Income Fund
PINV.TO	Purpose Global Innovators Fund
PIPE.TO	Pipestone Energy Corp
PKI.TO	Parkland Fuel Corp
PL.TO	Pinnacle Renewable Holdings Inc
PLC.TO	Park Lawn Corp
PLC.DB.TO	Park Lawn Corporation 5.75 Pct Debs
PLV.TO	Invesco Low Vol Portfolio ETF
PLZ.DB.E.TO	Plaza Retail REIT 5.10 Pct Debs
PLZ.UN.TO	Plaza Retail REIT
PMB.UN.TO	Picton Mahoney Tactical Income Fund
PME.TO	Sentry Select Primary Metals Corp
PMIF.TO	Pimco Monthly Income Fund
PMIF.U.TO	Pimco Monthly Income Fund
PMM.TO	Purpose Multi Strategy Mkt Neutral Fund
PMN.TO	Promis Neurosciences Inc
PMNT.TO	Pimco Global Short Maturity Fund ETF
PMT.TO	Perpetual Energy Inc
PMTS.TO	CPI Card Group Inc
PNC.A.TO	Postmedia Network Canada Corp Cl A
PNC.B.TO	Postmedia Network Canada Corp Cl B
PNE.TO	Pine Cliff Energy Ltd
PNP.TO	Pinetree Capital Ltd
POM.TO	Polymet Mining Corp
POU.TO	Paramount Resources Ltd
POW.TO	Power Corporation of Canada Sv
POW.PR.A.TO	Power Corp A Pr
POW.PR.B.TO	Power Corp Pref Shares Series B
POW.PR.C.TO	Power Corp of Canada 5.80%
POW.PR.D.TO	Power Corp Non-Cum 1st Pfd Shs Ser D
POW.PR.E.TO	Power Corp Part Pr
POW.PR.F.TO	Power Corp 1st Pr
POW.PR.G.TO	Power Corp of Canada 5.60 Pct Pref Ser G
PPL.TO	Pembina Pipeline Corp
PPL.PF.A.TO	Pembina Pipeline Corp Pref Ser 21
PPL.PF.C.TO	Pembina Pipeline Corp Pref Series 23
PPL.PF.E.TO	Pembina Pipeline Corp Pref Series 25
PPL.PR.A.TO	Pembina Pipeline Corp Pref Class A
PPL.PR.C.TO	Pembina Pipeline Corp Pref Ser 3
PPL.PR.E.TO	Pembina Pipeline Corp Pref Ser 5
PPL.PR.G.TO	Pembina Pipeline Corp Pref Ser 7
PPL.PR.I.TO	Pembina Pipeline Corp Pref Ser 9
PPL.PR.K.TO	Pembina Pipeline Corp Pref Ser 11
PPL.PR.M.TO	Pembina Pipeline Corp Pref Ser 13
PPL.PR.O.TO	Pembina Pipeline Corp Pref Series 15
PPL.PR.Q.TO	Pembina Pipeline Corp Pref Series 17
PPL.PR.S.TO	Pembina Pipeline Corp Pref Series 19
PPR.TO	Prairie Provident Resources Inc
PPS.TO	Invesco CDN Pref Share Idx ETF
PR.TO	Lysander Slater Pref Share Activ ETF
PRA.TO	Purpose Diversified Real Asset Fund ETF
PREF.TO	Evolve Dvdnd Stblt Prf Sh Indx E
PRM.TO	Big Pharma Split Corp
PRM.PR.A.TO	Big Pharma Split Corp Pref Shares
PRMW.TO	Primo Water Corporation
PRN.TO	Profound Medical Corp
PRP.TO	Purpose Conservative Income Fund ETF
PRQ.TO	Petrus Resources Ltd
PRU.TO	Perseus Mining Limited
PRV.UN.TO	Pro Real Estate Investment Trust
PSA.TO	Purpose High Interest Savings ETF
PSB.TO	Invesco 1 To 5 Yrladder Inv Grd Bd ETF
PSD.TO	Pulse Seismic Inc
PSI.TO	Pason Systems Inc
PSK.TO	Prairiesky Royalty Ltd
PSLV.TO	Sprott Physical Silver Trust CAD
PSLV.U.TO	Sprott Physical Silver Trust USD
PSU.U.TO	Purpose US Cash ETF
PSY.TO	Pwrshr Glb Sharehldr Yield ETF
PTI.UN.TO	Pimco Tactical Income Fund
PTM.TO	Platinum Group Metals Ltd
PTS.TO	Points International Ltd
PUD.TO	Purpose US Dividend Fund ETF
PUD.B.TO	Purpose US Dividend Fund ETF NC Hedged
PVG.TO	Pretium Resources Inc
PVS.PR.D.TO	Partners Value Split Corp Pref Ser 6
PVS.PR.E.TO	Partners Value Split Corp Pref Ser 7
PVS.PR.F.TO	Partners Value Split Corp Pref Ser 8
PVS.PR.G.TO	Partners Value Split Corp
PVS.PR.H.TO	Partners Value Split Corp Pref Ser 10
PVS.PR.I.TO	Partners Value Split Corp Pref Series 11
PWF.PR.A.TO	Power Fin Ser A Pr
PWF.PR.E.TO	Power Fin Ser D Pr
PWF.PR.F.TO	Power Financial Corp Pref Ser E
PWF.PR.G.TO	Power Financial Corp 5.90% Pr Series F
PWF.PR.H.TO	Power Financial Corp 5.75% Pr Series H
PWF.PR.I.TO	Power Financial Corp 6% Series I
PWF.PR.K.TO	Power Fin Corp 4.95% Ser K
PWF.PR.L.TO	Power Financial Corp Series L Pfd
PWF.PR.O.TO	Power Financial Corp 5.80 Pref Ser O
PWF.PR.P.TO	Pwr Fnl Corp 4.40 Non Cumul Pref Ser P
PWF.PR.Q.TO	Power Fin Corp 4.40 Pct Pref Ser Q
PWF.PR.R.TO	Power Financial Corp 5.5 Pct Pref Ser R
PWF.PR.S.TO	Power Financial Corp Pref Ser S
PWF.PR.T.TO	Power Financial Corp 4.20 Pct Pref Ser T
PWF.PR.Z.TO	Power Financial Corp 5.15 Pct Pref Ser V
PXC.TO	Invesco FTSE RAFI CAD Idx ETF
PXG.TO	Invesco FTSE RAFI Global Plus ETF
PXG.U.TO	Invesco FTSE RAFI Global Plus ETF USD
PXS.TO	Pwrshr FTSE RAFI US Fdamntl ETF II
PXT.TO	Parex Resources Inc
PXU.F.TO	Invesco FTSE RAFI US Idx ETF
PYF.TO	Purpose Premium Yield Fund ETF
PYF.B.TO	Purpose Premium Yield Fund Non Hdg ETF
PYF.U.TO	Purpose Premium Yield Fund NH USD ETF
PYR.TO	Pyrogenesis Canada Inc
PZA.TO	Pizza Pizza Royalty Corp
PZC.TO	Pwrshr FTSE RAFI CDN Sml Mid Fdamntl ETF
PZW.TO	Pwrshr FTSE RAFI Glb Sml Mid Fdamntl ETF
PZW.F.TO	Invesco FTSE RAFI Glb Small Mid Hedge
QAH.TO	Mackenzie US Large Cap Eqty Idx CAD Hgd
QBB.TO	Mackenzie CDN Aggregate Bond Index ETF
QBR.A.TO	Quebecor Inc Cl.A Mv
QBR.B.TO	Quebecor Inc Cl.B Sv
QBTC.TO	The Bitcoin Fund CAD
QBTC.U.TO	The Bitcoin Fund
QBTL.TO	Agfiq US Mkt Neut Antibeta CAD Hdg ETF
QCD.TO	Quantshrs Enh Core CDN Equity ETF
QCE.TO	Mackenzie CDN Large Cap Equity Index ETF
QCN.TO	Mackenzie Canadian Equity Index ETF
QDX.TO	Mackenzie International Equity Index ETF
QEBH.TO	Mackenzie Emerging Mkts Bond Index ETF
QEBL.TO	Mackenzie Emerging Mkts Local Cur Bd ETF
QEC.TO	Questerre Energy Corp
QEM.TO	Quantshrs Enh Core Emg Mkt Eqt ETF
QETH.U.TO	Ether Fund (The)
QHY.TO	Mackenzie US High Yld Bnd Idx CAD Hgd
QIE.TO	Quantshrs Enh Core Intl Equity ETF
QINF.TO	Mackenzie Global Infrastructure Indx ETF
QMA.TO	Quantshrs Multiasset Allocation ETF
QQC.F.TO	Invesco QQQ Index ETF
QSB.TO	Mackenzie CDN Short Term Bond Index ETF
QSP.UN.TO	Restaurant Brands Intl Ltd Partnership
QSR.TO	Restaurant Brands International Inc
QTRH.TO	Quarterhill Inc
QUB.TO	Mackenzie US Aggregate Bond Indx Hgd ETF
QUIG.TO	Mackenzie US Inv Grd Corp Bd Idx CAD Hgd
QUS.TO	Quantshrs Enh Core US Equity ETF
QUU.TO	Mackenzie US Large Cap Equity Index ETF
QUU.U.TO	Mackenzie US Large Cap Eqty Indx USD ETF
QXM.TO	CI First Asset Morningstar Nb Quebec ETF
RA.UN.TO	Middlefield Global Real Asset Fund
RAY.A.TO	Stingray Digital Group Inc Sv
RAY.B.TO	Stingray Digital Group Inc Variable Sv
RBA.TO	Ritchie Bros Auctioneers Inc
RBDI.TO	RBC Bluebay Global Income ETF
RBN.UN.TO	Blue Ribbon Income Fund
RBNK.TO	RBC CDN Bank Yield Index ETF
RBO.TO	RBC 1 To 5 Yr Laddered Corp Bond ETF
RBOT.TO	Horizons Robotics Automation Idx ETF
RBOT.U.TO	Horizons Robotics and Automa Idx ETF USD
RCD.TO	RBC Quant CDN Dividend Leaders ETF
RCE.TO	RBC Quant Canadian Equity Leaders ETF
RCG.TO	RF Capital Group Inc
RCG.PR.B.TO	RF Capital Group Inc Pref B
RCG.PR.C.TO	RF Capital Group Inc Pref C
RCH.TO	Richelieu Hardware Ltd
RCI.A.TO	Rogers Communications Inc Cl.A Mv
RCI.B.TO	Rogers Communications Inc Cl.B NV
RCO.UN.TO	Middlefield Can Global REIT Income Fund
RDL.TO	Redline Communications Group Inc
REAL.TO	Real Matters Inc
RECP.TO	Recipe Unlimited Corp
REI.UN.TO	Riocan Real Est Un
REIT.TO	Powershares Sptsx REIT Income Idx ETF
RFP.TO	Resolute Forest Products Inc
RGRE.TO	RBC Qnt Global Real Estate Ldrs
RIB.UN.TO	Ridgewood CAD Invest Grade Bond Fund
RID.TO	RBC Quant EAFE Div Leaders ETF
RID.U.TO	RBC Quant EAFE Div Leaders USD ETF
RIDH.TO	RBC Quant EAFE Div Leaders ETF
RIE.TO	RBC Quant EAFE Equity Leaders ETF
RIE.U.TO	RBC Quant EAFE Equity Leaders ETF USD
RIEH.TO	RBC Quant EAFE Equity Leaders CAD Heg ETF
RIFI.TO	Russell Invt Fixed Income Pool ETF
RIG.TO	RBC Quant Global Infras Leaders ETF
RIIN.TO	Russell Invt Global Infr Pool ETF
RIRA.TO	Russell Invt Real Assets ETF
RIT.TO	CI First Asset Canadian REIT ETF
RIV.TO	Canopy Rivers Inc
RLB.TO	RBC 1 To 5 Year Laddered Can Bond ETF
RLD.TO	RBC Strategic Global Div Leaders ETF
RLE.TO	RBC Stategic Global Equity Leaders ETF
RMBO.TO	RBC 6 To 10 Yr CDN Corp Bond ETF
RME.TO	Rocky Mountain Dealerships Inc
RNW.TO	Transalta Renewables Inc
ROOT.TO	Roots Corporation
ROXG.TO	Roxgold Inc
RPD.TO	RBC Quant European Div Leaders ETF
RPD.U.TO	RBC Quant European Div Leaders ETF USD
RPDH.TO	RBC Quant European Div Leaders ETF
RPF.TO	RBC Canadian Pref Share ETF
RPI.UN.TO	Richards Packaging Income Fund
RPSB.TO	RBC Phn Short Term CDN Bond ETF
RQI.TO	RBC Target 2021 Corp Bond Index ETF
RQJ.TO	RBC Target 2022 Corp Bond ETF
RQK.TO	RBC Target 2023 Corp Bond ETF
RQL.TO	RBC Target 2024 Corp Bond Index ETF
RQN.TO	RBC Target 2025 Corp Bond Index ETF
RQO.TO	RBC Target 2026 Corporate Bond Index ETF
RQP.TO	RBC Target 2027 Corporate Bond Index ETF
RS.TO	Real Estate and Ecommerce Split Corp
RS.PR.A.TO	Real Estate & E-Commerce Split Corp
RSI.TO	Rogers Sugar Inc
RSI.DB.E.TO	Rogers Sugar Inc 5Pct Debs
RSI.DB.F.TO	Rogers Sugar Inc 4.75 Pct Debs
RTG.TO	Rtg Mining Inc
RUBH.TO	RBC US Banks Yield CAD Hgd Index ETF
RUBY.TO	RBC US Banks Yield Index ETF CAD
RUBY.U.TO	RBC US Banks Yield Index ETF USD
RUD.TO	RBC Quant US Div Leaders ETF
RUD.U.TO	RBC Quant US Div Leaders USD ETF
RUDH.TO	RBC Quant US Div Leaders ETF
RUE.TO	RBC Quant US Equity Leaders ETF
RUE.U.TO	RBC Quant US Equity Leaders ETF USD
RUS.TO	Russel Metals
RUSB.TO	RBC Short Term US Corp Bond ETF
RUSB.U.TO	RBC Short Term US Corp Bond USD
RVX.TO	Resverlogix Corp
RVX.WT.TO	Resverlogix Corp WT
RVX.WT.A.TO	Resverlogix Corp WT
RWC.TO	CI First Asset MSCI Canada Low Risk Wtd ETF
RWE.TO	CI First Asset MSCI Europe Lr Wgtd ETF
RWE.B.TO	CI First Asset MSCI Europe Lr Wgtd Unhg ETF
RWU.TO	CI First Asset MSCI USA Lr Wgtd ETF
RWU.B.TO	CI First Asset MSCI USA Lr Wgtd Unhedg ETF
RWW.TO	CI First Asset MSCI World Low Risk Wtd ETF
RWW.B.TO	CI First Asset MSCI Wld Lr Wtd Uh ETF
RWX.TO	CI First Asset MSCI Intl Low Risk Weighted ETF
RWX.B.TO	CI First Asset MSCI Intl Low Risk Wghtd Unhgd Et
RXD.TO	RBC Quant Emrg Mkts Div Leaders ETF
RXD.U.TO	RBC Quant Emrg Mkts Div Leaders ETF USD
RXE.TO	RBC Quant Emrg Mkts Equity Leaders ETF
RXE.U.TO	RBC Quant Emrg Mkts Eqt Leaders ETF USD
RY.TO	Royal Bank of Canada
RY.PR.H.TO	Royal Bank Pref Ser Bb
RY.PR.J.TO	Royal Bank Pref Ser Bd
RY.PR.M.TO	Royal Bank Pref Ser Bf
RY.PR.N.TO	Royal Bank Pref Ser Bh
RY.PR.O.TO	Royal Bank Pref Ser Bi
RY.PR.P.TO	Royal Bank Pref Ser Bj
RY.PR.Q.TO	Royal Bank Pref Ser Bk
RY.PR.R.TO	Royal Bank Pref Ser Bm
RY.PR.S.TO	RBC Pref Shares Series Bo
RY.PR.Z.TO	RBC First Pref Sh Series AZ
S.TO	Sherritt Intl Rv
S.WT.TO	Sherritt International Corporation WT
SAM.TO	Starcore International Mines Ltd
SAP.TO	Saputo Inc
SAU.TO	ST Augustine Gold and Copper Ltd
SBB.TO	Sabina Gold and Silver Corp
SBC.TO	Brompton Split Banc Corp Cl A
SBC.PR.A.TO	Brompton Split Banc Corp Pref
SBI.TO	Serabi Gold Plc
SBN.TO	S Split Corp Cl.A
SBN.PR.A.TO	S Split Corp Pref A
SBR.TO	Silver Bear Resources Plc
SBT.TO	Purpose Silver Bullion ETF
SBT.B.TO	Silver Bullion Trust CAD ETF Non Cur
SBT.U.TO	Silver Bullion Trust USD ETF Non Cur
SCAD.TO	Scotia Strategic CDN Eqty ETF Portfolio
SCL.TO	Shawcor Ltd
SCR.TO	Score Media and Gaming Inc
SCY.TO	Scandium International Mining Corp
SEA.TO	Seabridge Gold Inc
SEC.TO	Senvest Capital
SES.TO	Secure Energy Services Inc
SFC.TO	Sagicor Financial Company Ltd
SFC.WT.TO	Sagicor Financial Company Ltd Wts
SFD.TO	Nxt Energy Solutions Inc
SFIX.TO	Scotia Strategic Fixed Inc ETF Portfolio
SGR.U.TO	Slate Grocery REIT USD
SGR.UN.TO	Slate Grocery REIT
SGY.TO	Surge Energy Inc
SGY.DB.TO	Surge Energy Inc 5.75 Pct Debs
SGY.DB.A.TO	Surge Energy Inc  6.75 Pct Debs
SHLE.TO	Source Energy Services Ltd
SHOP.TO	Shopify Inc
SIA.TO	Sienna Senior Living Inc
SID.TO	CI First Asset US Trendleaders ETF
SIH.UN.TO	Sustainable Innovation & Health Dividend
SII.TO	Sprott Inc
SIL.TO	Silvercrest Metals Inc
SINT.TO	Scotia Strategic Intl Eqty ETF Portfolio
SIS.TO	Savaria Corp
SJ.TO	Stella Jones Inc
SJR.B.TO	Shaw Communications Inc Cl.B NV
SJR.PR.A.TO	Shaw Communications Inc Pref Ser A
SJR.PR.B.TO	Shaw Communications Inc Pref Ser B
SKE.TO	Skeena Resources Limited
SLF.TO	Sun Life Financial Inc
SLF.PR.A.TO	Sun Life Pref Ser 1
SLF.PR.B.TO	Sun Life Pref Ser 2
SLF.PR.C.TO	Sun Life Pref Ser 3
SLF.PR.D.TO	Sun Life Pref Ser 4
SLF.PR.E.TO	Sun Life Pref Ser 5
SLF.PR.G.TO	Sun Life Pref Ser 8R
SLF.PR.H.TO	Sun Life Pref Ser H
SLF.PR.I.TO	Sun Life Pref Ser 12R
SLF.PR.J.TO	Sun Life Pref Ser 9Qr
SLF.PR.K.TO	Sun Life Pref Ser 11Qr
SLR.TO	Solitario Zinc Corp
SMC.TO	Sulliden Mining Capital Inc
SMT.TO	Sierra Metals Inc
SMU.UN.TO	Summit Industrial Income REIT
SNC.TO	Snc-Lavalin Sv
SOLG.TO	Solgold Plc
SOP.TO	Soperior Fertilizer Corp
SOT.DB.TO	Slate Office REIT 5.25 Pct Debs
SOT.UN.TO	Slate Office REIT
SOY.TO	Sunopta Inc
SPB.TO	Superior Plus Corp
SPG.TO	Spark Power Group Inc
SPG.WT.TO	Spark Power Group Inc WT
SPPP.TO	Sprott Physical Platinum Palladium CAD
SPPP.U.TO	Sprott Physical Platinum Palladium USD
SRHI.TO	Sprott Resource Holdings Inc
SRHI.WT.TO	Sprott Resource Holdings Inc WT
SRU.UN.TO	Smartcentres Real Estate Investment Trust
SRV.UN.TO	Sir Royalty Income Fund
SRX.TO	Storm Resources Ltd
SSF.UN.TO	Symphony Floating Rate Sr Loan Fd
SSL.TO	Sandstorm Gold Ltd
SSRM.TO	Ssr Mining Inc
STEP.TO	Step Energy Services Ltd
STGO.TO	Steppe Gold Ltd
STLC.TO	Stelco Holdings Inc
STN.TO	Stantec Inc
STPL.TO	BMO Glb Consumer Staples Hgd To CAD ETF
SU.TO	Suncor Energy Inc
SUSA.TO	Scotia Strategic US Eqty ETF Portfolio
SVB.TO	Silver Bull Resources Inc
SVM.TO	Silvercorp Metals Inc
SVR.TO	Ishares Silver Bullion ETF Hdg
SVR.C.TO	Ishares Silver Bullion ETF Non Hdg
SW.TO	Sierra Wireless
SWP.TO	Swiss Water Decaffeinated Coffee Inc
SXI.TO	Synex Intl J
SXP.TO	Supremex Inc
SYLD.TO	Purpose Strategic Yield Fund
SZLS.TO	Stagezero Life Sciences Ltd.
SZLS.WS.TO	Stagezero Life Sciences Ltd Warrants
SZLS.WT.TO	Stagezero Life Sciences Ltd Wts
T.TO	Telus Corp
TA.TO	Transalta Corp
TA.PR.D.TO	Transalta Corp Prfd Series A
TA.PR.E.TO	Transalta Corp Pref Ser B
TA.PR.F.TO	Transalta Corp Pref Ser C
TA.PR.H.TO	Transalta Corp Pref Sh Series E
TA.PR.J.TO	Transalta Corp Pref Ser G
TBL.TO	Taiga Building Products Ltd
TBP.TO	Tetra Bio Pharma Inc
TBP.WT.TO	Tetra Bio Pharma Inc WT
TBP.WT.A.TO	Tetra Bio Pharma Inc WT A
TBP.WT.B.TO	Tetra Bio Pharma Inc Wts B
TC.TO	Tucows Inc
TCL.A.TO	Transcontinental Inc Cl A Sv
TCL.B.TO	Transcontinental Inc Cl B Mv
TCLB.TO	TD Canadian Long Term Fed Bond ETF
TCLV.TO	TD Q Canadian Low Volatility ETF
TCN.TO	Tricon Capital Group Inc
TCN.DB.U.TO	Tricon Capital Group 5.75 Pct Debs USD
TCS.TO	Tecsys Inc J
TCSB.TO	TD Select Short Term Corporate Bond Ladd
TCT.UN.TO	Top 10 Canadian Financial Trust
TCW.TO	Trican Well
TD.TO	Toronto-Dominion Bank
TD.PF.A.TO	TD Bank Pref Ser 1
TD.PF.B.TO	TD Bank Pref Ser 3
TD.PF.C.TO	TD Bank Pref Ser 5
TD.PF.D.TO	TD Bank Pref Ser 7
TD.PF.E.TO	TD Bank Pref Ser 9
TD.PF.G.TO	TD Bank Pref Ser 12
TD.PF.H.TO	TD Bank Pref Ser 14
TD.PF.I.TO	TD Bank Pref Ser 16
TD.PF.J.TO	TD Bank Pref Series 18
TD.PF.K.TO	TD Bank Pref Series 20
TD.PF.L.TO	TD Bank Pref Series 22
TD.PF.M.TO	TD Bank Pref Series 24
TDB.TO	TD CDN Aggregate Bond Index ETF
TEC.TO	TD Global Technology Leaders Index ETF
TECK.A.TO	Teck Resources Limited Cl A
TECK.B.TO	Teck Resources Limited Cl B
TERM.TO	Manulife Smart Short-Term Bond ETF
TEV.TO	Tervita Corporation
TF.TO	Timbercreek Financial Corp
TF.DB.B.TO	Timbercreek Financial Corp 5.45 Pct Debs
TF.DB.C.TO	Timbercreek Financial Corp 5.30 Pct Debs
TFII.TO	Tfi International Inc
TGED.TO	TD Active Global Enhanced Dividend ETF
TGFI.TO	TD Active Global Income ETF
TGGR.TO	TD Active Global Equity Growth ETF
TGL.TO	Transglobe Energy Corp
TGO.TO	Terago Inc
TGOD.TO	The Green Organic Dutchman Holdings Ltd
TGOD.WA.TO	The Green Organic Dutchman Hlds Ltd WA
TGOD.WB.TO	The Green Organic Dutchman Hlds Ltd Wb
TGOD.WR.TO	Green Organic Dutchman Holdings Ltd WT
TGOD.WS.TO	The Green Organic Dutchman Hlds Ltd Ws
TGOD.WT.TO	The Green Organic Dutchman Holdings WT
TGRE.TO	TD Active Global Real Estate Equity ETF
TGZ.TO	Teranga Gold Corp
TH.TO	Theratechnologies
TH.DB.U.TO	Theratechnologies 5.75 Pct Debs
The.TO	TD Intl Equity CAD Hedge Index ETF
THU.TO	TD S&P 500 CAD Hedge Index ETF
TI.TO	Titan Mining Corporation
TIH.TO	Toromont Ind
TILV.TO	TD Systematic Intl Equity Low Vol ETF
TINF.TO	TD Active Global Infrastructure Eqty ETF
TKO.TO	Taseko Mines Ltd
TLF.TO	Brompton Tech Leaders Income ETF
TLF.U.TO	Brompton Tech Leaders Income ETF USD
TLG.TO	Troilus Gold Corp
TLO.TO	Talon Metals Corp
TLV.TO	Invesco SP TSX Low Vol Idx ETF
TMD.TO	Titan Medical Inc
TMD.WT.G.TO	Titan Medical Inc WT Cl G
TMD.WT.H.TO	Titan Medical Inc WT Cl H
TMD.WT.I.TO	Titan Medical Inc WT Cl I
TMEC.TO	TD Morningstar ESG Cda Eqty Idx ETF
TMEI.TO	TD Morningstar ESG Intl Eqty Idx ETF
TMEU.TO	TD Morningstar ESG US Equity Index ETF
TML.TO	Treasury Metals Inc
TMQ.TO	Trilogy Metals Inc
TMR.TO	Tmac Resources Inc
TNP.TO	Transatlantic Petroleum Ltd
TNT.UN.TO	True North Commercial REIT
TNX.TO	Tanzanian Royalty Exploration Corp
TOCA.TO	TD One Click Aggressive Portfolio ETF
TOCC.TO	TD One Click Conservative ETF Portfolio
TOCM.TO	TD One Click Moderate ETF Portfolio
TOG.TO	Torc Oil and Gas Ltd
TOT.TO	Total Energy Services Inc
TOU.TO	Tourmaline Oil Corp
TOY.TO	Spin Master Corp
TPAY.TO	TD Income Builder ETF
TPE.TO	TD International Equity Index ETF
TPRF.TO	TD Active Preferred Share ETF
TPU.TO	TD S&P 500 Index ETF
TPX.A.TO	Molson Coors Canada Inc Cl.A Lv
TPX.B.TO	Molson Coors Canada Inc Cl.B NV
TPZ.TO	Topaz Energy Corp
TQCD.TO	TD Q Canadian Dividend ETF
TQGD.TO	TD Q Global Dividend ETF
TQGM.TO	TD Q Global Multifactor ETF
TQSM.TO	TD Q US Small Mid Cap Eqty ETF
TRI.TO	Thomson Reuters Corp
TRI.PR.B.TO	Thomson Reuters Corporation Prf Srs 2
TRIL.TO	Trillium Therapeutics Inc
TRL.TO	Trilogy International Partners Inc
TRL.WT.TO	Trilogy International Partners Inc WT
TRP.TO	Tc Energy Corp
TRP.PR.A.TO	Transcanada Corp Pref Ser 1
TRP.PR.B.TO	Transcanada Corp Pref Ser 3
TRP.PR.C.TO	Transcanada Corp Pref Ser 5
TRP.PR.D.TO	Transcanada Corp Pref Ser 7
TRP.PR.E.TO	Transcanada Corp Pref Ser 9
TRP.PR.F.TO	Transcanada Corp Pref Ser 2
TRP.PR.G.TO	Transcanada Corp Pref Ser 11
TRP.PR.H.TO	Transcanada Corp Pref Ser 4
TRP.PR.I.TO	Transcanada Corp Pref Ser 6
TRP.PR.J.TO	Transcanada Corp Pref Ser 13
TRP.PR.K.TO	Transcanada Corp Pref Ser 15
TRQ.TO	Turquoise Hill Resources Ltd
TRZ.TO	Transat At Inc
TSK.TO	Talisker Resources Ltd
TSL.TO	Tree Island Steel Ltd
TSU.TO	Trisura Group Ltd
TTP.TO	TD S&P TSX Capped Comp Index ETF
TUED.TO	TD Active US Enhanced Dividend ETF
TUHY.TO	TD Active US High Yield Bond ETF
TULB.TO	TD US Long Term Treasury Bond ETF
TULV.TO	TD Q US Low Volatility ETF
TUSB.TO	TD Select U.S. Short Term Corporate Bond
TUSB.U.TO	TD Select US Short Term Corp Bnd ETF USD
TUT.UN.TO	Top 20 US Dividend Trust Cls A Units
TV.TO	Trevali Mining Corp
TV.WT.TO	Trevali Mining Corporation Wts
TVA.B.TO	Tva Group Inc Cl.B NV
TVE.TO	Tamarack Valley Energy Ltd
TVK.TO	Terravest Capital Inc
TWC.TO	Twc Enterprises Limited
TWM.TO	Tidewater Midstream and Infras Ltd
TWM.DB.TO	Tidewater Midstream Infras 5.5 Pct Debs
TXF.TO	CI First Asset Tech Giants Covered Call ETF
TXF.B.TO	CI First Asset Tech Giants Cov Call Unheg
TXG.TO	Torex Gold Resources Inc
TXP.TO	Touchstone Exploration Inc
TXT.PR.A.TO	Top 10 Split Trust Pref A
TXT.UN.TO	Top 10 Split Trust
TZS.TO	Trez Capital Senior Mortgage Inv Corp
U.TO	Uranium Participation CO
UDA.TO	Caldwell US Dividend Advantage Fund ETF
UDIV.TO	Manulife Smart U.S. Dividend ETF (Hedged
UEX.TO	Uex Corp
UFS.TO	Domtar Corp
ULV.C.TO	Powershares Sp500 Low Volatility ETF
ULV.F.TO	Invesco S&P 500 Low Volatility ETF
ULV.U.TO	Invesco S&P 500 Low Volatility ETF USD
UMI.TO	CI Wisdomtree US Midcap Div Idx ETF
UMI.B.TO	Wisdomtree US Midcap Div Idx Unheg ETF
UNC.TO	United Corp Ltd
UNI.TO	Unisync Corp Class B
UNS.TO	Uni Select Inc
URB.TO	Urbana Corporation
URB.A.TO	Urbana Corporation A NV
URE.TO	Ur-Energy Inc
USA.TO	Americas Silver Corp
USB.TO	Powershares Lad US 0 To 5 Yr Corp Bd ETF
USB.U.TO	Powershares Lad US 0 To 5 Yr Corp Bd ETF USD
USF.UN.TO	US Financials Income Fund
UTE.UN.TO	Canadian Utilities Telecom Inc Fd
UXM.TO	CI First Asset Morningstar US Div Tgt 50 ETF
UXM.B.TO	CI First Asset Morningstar US Div Tgt 50 ETF Unh
VA.TO	Vanguard FTSE Dev Asia Pac All Cap ETF
VAB.TO	Vanguard CDN Aggregate Bond Index ETF
VB.TO	Versabank
VB.PR.A.TO	Versabank Pref Ser 1
VB.PR.B.TO	Versabank Pref Ser 3
VBAL.TO	Vanguard Balanced ETF Portfolio
VBG.TO	Vanguard Global Ex US Agg Bnd ETF
VBU.TO	Vanguard US Agg Bond Index ETF CAD
VCB.TO	Vanguard CDN Corporate Bond Index ETF
VCE.TO	Vanguard FTSE Canada Index ETF
VCIP.TO	Vanguard Conservative Income ETF
VCM.TO	Vecima Networks Inc
VCN.TO	Vanguard FTSE Canada All Cap ETF
VCNS.TO	Vanguard Conservative ETF Portfolio
VDU.TO	Vanguard FTSE Developed AC Ex US ETF
VDY.TO	Vanguard FTSE CDN High Div Yld Index ETF
VE.TO	Vanguard FTSE Dev Europe All Cap ETF
VEE.TO	Vanguard FTSE Emerging Mkts All Cap ETF
VEF.TO	Vanguard FTSE Dev AC Ex US ETF CAD Hdg
VEQT.TO	Vanguard All Equity ETF Portfolio
VET.TO	Vermilion Energy Inc
VFF.TO	Village Farms International Inc
VFV.TO	Vanguard S&P 500 Index ETF
VGAB.TO	Vanguard Global Aggregate Bond Index ETF
VGCX.TO	Victoria Gold Corp
VGG.TO	Vanguard US Div Appr ETF
VGH.TO	Vanguard US Div Appr ETF CAD Hdg
VGRO.TO	Vanguard Growth ETF Portfolio
VGV.TO	Vanguard CDN Government Bond Index ETF
VGZ.TO	Vista Gold Corp
VI.TO	Vanguard FTSE Dev All Cap Na ETF
VIDY.TO	Vanguard FTSE Dev Ex Na High Div Yld ETF
VII.TO	Seven Generations Energy Ltd
VIU.TO	Vanguard FTSE Dev All Cap Na ETF
VIVO.TO	Vivo Cannabis Inc
VLB.TO	Vanguard CDN Long Term Bond Index ETF
VLE.TO	Valeura Energy Inc
VLN.TO	Velan Inc Sv
VLNS.TO	Valens Groworks Corp
VLNS.WT.TO	Valens Groworks Corp Wts
VMD.TO	Viemed Healthcare Inc
VMO.TO	Vanguard Glob Momentum Factor ETF
VNP.TO	5N Plus Inc
VRE.TO	Vanguard FTSE CDN Capped REIT Index ETF
VRIF.TO	Vanguard Retirement Income ETF
VSB.TO	Vanguard CDN Short-Term Bond Index ETF
VSC.TO	Vanguard CDN Short Term Corp Bd ETF
VSP.TO	Vanguard S&P 500 Index ETF CAD Hdg
VUN.TO	Vanguard US Total Market ETF
VUS.TO	Vanguard US Total Mkt ETF CAD Hdg
VVL.TO	Vanguard Glob Val Factor ETF
VVO.TO	Vanguard Global Min Vol ETF
VXC.TO	Vanguard FTSE Global All Cap Ex Can ETF
VXM.TO	CI First Asset Morningstar Intl Value ETF
VXM.B.TO	CI First Asset Morningstar Intl Value ETF Unheg
W.PR.K.TO	Westcoast Energy Inc Pref Ser 10
W.PR.M.TO	Westcoast Energy Inc Pref Ser 12
WBR.TO	Waterloo Brewing Ltd.
WCM.A.TO	Wilmington Capital Mgmt Inc Cl A NV
WCM.B.TO	Wilmington Capital Management Cl B
WCN.TO	Waste Connections Inc
WCP.TO	Whitecap Resources Inc
WDO.TO	Wesdome Gold Mines Ltd
WEED.TO	Canopy Growth Corp
WEF.TO	Western Forest Products Inc
WELL.TO	Well Health Technologies Corp
WFC.TO	Wall Financial
WFS.TO	World Financial Split Corp
WFS.PR.A.TO	World Financial Split Corp
WFT.TO	West Fraser Timber CO Ltd
WILD.TO	Wildbrain Ltd.
WILD.DB.TO	Wildbrain Ltd 5.875 Pct Debs
WIR.U.TO	Wpt Industrial REIT USD
WIR.UN.TO	Wpt Industrial REIT Units
WJX.TO	Wajax Corp
WJX.DB.TO	Wajax Corporation 6.00 Pct Debs
WLLW.TO	Willow Biosciencesinc
WLLW.WT.TO	Willow Biosciences Inc Warrants
WM.TO	Wallbridge Mining Company Ltd
WN.TO	Weston George
WN.PR.A.TO	George Weston Pref Ser 1
WN.PR.C.TO	George Weston 5.20% Pref Ser III
WN.PR.D.TO	George Weston 5.2% Pref Ser IV
WN.PR.E.TO	George Weston 4.75% Pref Ser V
WOMN.TO	BMO Women IN Leadership Fund
WPK.TO	Winpak Ltd
WPM.TO	Wheaton Precious Metals Corp
WPRT.TO	Westport Fuel Systems Inc
WRG.TO	Western Energy Services Corp
WRN.TO	Western Copper and Gold Corp
WRX.TO	Western Resources Corp
WSP.TO	WSP Global Inc
WSRD.TO	Wealthsimple Dev Mkt Ex Na Soc Resp ETF
WSRI.TO	Wealthsimple Na Socially Resp Index ETF
WTE.TO	Westshore Terminals Investment Corp
WXM.TO	CI First Asset Morningstar Cda Momentum ETF
X.TO	Tmx Group Limited
XAM.TO	Xanadu Mines Ltd
XAU.TO	Goldmoney Inc
XAW.TO	Ishares Core MSCI All Cntry Ex Can ETF
XAW.U.TO	Ishares Core MSCI All Ex Can ETF USD
XBAL.TO	Ishares Core Balanced ETF Portfolio
XBB.TO	Ishares Core CDN Universe Bond ETF
XBM.TO	Ishares S&P TSX Global Base Mtls ETF
XCB.TO	Ishares Canadian Corporate Bond ETF
XCD.TO	Ishares S&P Global Cons Disc ETF
XCG.TO	Ishares Canadian Growth Index ETF
XCH.TO	Ishares China Index ETF
XCNS.TO	Ishares Core Conservative Balanced ETF
XCS.TO	Ishares S&P TSX Smallcap Index ETF
XCSR.TO	Ishares ESG Advanced MSCI Canada Idx ETF
XCT.TO	Exactearth Ltd
XCV.TO	Ishares Canadian Value Index ETF
XDG.TO	Ishares Core MSCI Glo Qlty Div ETF
XDG.U.TO	Ishares Core MSCI Glo Qlty Div ETF USD
XDGH.TO	Ishares Core MSCI Glo Qlty Div ETF
XDIV.TO	Ishares Core MSCI CAD Qlty Div ETF
XDSR.TO	Ishares ESG Advanced MSCI EAFE Index ETF
XDU.TO	Ishares Core MSCI US Qlty Div ETF
XDU.U.TO	Ishares Core MSCI US Qlty Div ETF USD
XDUH.TO	Ishares Core MSCI US Qlty Div ETF
XDV.TO	Ishares Canadian Select Div Index ETF
XEB.TO	Ishares JP Morgan USD Emerg Mkts Bd ETF
XEC.TO	Ishares Core MSCI Emerging Mkts IMI ETF
XEC.U.TO	Ishares Core MSCI Emrgng Mkt IMI ETF
XEF.TO	Ishares Core MSCI EAFE IMI Index ETF
XEF.U.TO	Ishares Core MSCI EAFE IMI Index ETF
XEG.TO	Ishares S&P TSX Capped Energy Index ETF
XEH.TO	Ishares MSCI Europe IMI Index ETF
XEI.TO	Ishares S&P TSX Comp High Div Index ETF
XEM.TO	Ishares MSCI Emerging Markets ETF
XEN.TO	Ishares Jantzi Social Index ETF
XEQT.TO	Ishares Core Equity ETF
XESG.TO	Ishares ESG MSCI Cda Index ETF
XEU.TO	Ishares MSCI Europe IMI Index ETF
XFA.TO	Ishares Edge MSCI Multifact USA Idx CAD
XFC.TO	Ishares Edge MSCI Multifact Can ETF
XFF.TO	Ishares Edge MSCI Multifact EAFE Idx CAD
XFH.TO	Ishares Core MSCI EAFE IMI Index ETF
XFI.TO	Ishares Edge MSCI Multifact EAFE ETF
XFN.TO	Ishares S&P TSX Capped Financials ETF
XFR.TO	Ishares Floating Rate Index ETF
XFS.TO	Ishares Edge MSCI Multifact USA ETF
XGB.TO	Ishares Canadian Govt Bond Index ETF
XGD.TO	Ishares S&P TSX Global Gold Index ETF
XGI.TO	Ishares S&P Global Industrials ETF
XGRO.TO	Ishares Core Growth ETF Portfolio
XHB.TO	Ishares CDN Hybrid Corp Bond ETF
XHC.TO	Ishares Global Healthcare Index ETF
XHD.TO	Ishares US High Div Equity Index ETF
XHU.TO	Ishares US High Div Equity Index ETF
XHY.TO	Ishares US High Yield Bond Index ETF
XIC.TO	Ishares Core S&P TSX Capped Comp ETF
XID.TO	Ishares India Index ETF
XIG.TO	Ishares US IG Corporate Bond Index ETF
XIN.TO	Ishares MSCI EAFE Index ETF
XINC.TO	Ishares Core Income Balanced ETF
XIT.TO	Ishares S&P TSX Capped Info Tech ETF
XIU.TO	Ishares S&P TSX 60 Index ETF
XLB.TO	Ishares Core CDN Long Term Bond ETF
XMA.TO	Ishares S&P TSX Capped Materials ETF
XMC.TO	Ishares S&P US Midcap Index ETF
XMC.U.TO	Ishares SP US Midcap ETF USD
XMD.TO	Ishares S&P TSX Completion Index ETF
XMF.A.TO	M Split Corp Capital Shares 2014
XMF.PR.B.TO	M Split Corp Class I Pref Shares
XMF.PR.C.TO	M Split Corp Class II Pref Shares 2014
XMH.TO	Ishares S&P US Midcap Index ETF CAD Hgd
XMI.TO	Ishares Edge MSCI Min Vol EAFE ETF
XML.TO	Ishares Edge MSCI Mv EAFE ETF CAD Hgd
XMM.TO	Ishares Edge MSCI Min Vol Emerg ETF
XMS.TO	Ishares Edge MSCI Mv USA ETF CAD Hgd
XMTM.TO	Ishares Edge MSCI USA Momnt Fctr ETF
XMU.TO	Ishares Edge MSCI Min Vol USA ETF
XMU.U.TO	Ishares Edge MSCI Min Vol USA Index ETF
XMV.TO	Ishares Edge MSCI Min Vol Can ETF
XMW.TO	Ishares Edge MSCI Min Vol Gbl ETF
XMY.TO	Ishares Edge MSCI Mv Global ETF CAD Hgd
XPF.TO	Ishares S&P TSX Na Pref Stock ETF
XQB.TO	Ishares High Qlty Canadian Bond ETF
XQLT.TO	Ishares Edge MSCI USA Qlty Fctr Indx ETF
XQQ.TO	Ishares Nasdaq 100 Index ETF
XRB.TO	Ishares CDN Real Return Bond Index ETF
XRE.TO	Ishares S&P TSX Capped REIT Index ETF
XSAB.TO	Ishares ESG CDN Agg Bond Index ETF
XSB.TO	Ishares Core CDN Short Trm Bond ETF
XSC.TO	Ishares Cons ST Strat Fix Inc ETF
XSE.TO	Ishares Cons Strat Fix Inc ETF
XSEA.TO	Ishares ESG MSCI EAFE Index ETF
XSEM.TO	Ishares ESG MSCI Emerg Mkts Index ETF
XSH.TO	Ishares Core CDN ST Corp Maple Bnd ETF
XSI.TO	Ishares Short Term Strategic FI ETF
XSMC.TO	Ishares SP US Small Cap Index ETF
XSMH.TO	Ishares SP US Small Cap ETF CAD Hdg
XSP.TO	Ishares Core S&P 500 ETF CAD Hdg ETF
XSQ.TO	Ishares ST HI Qlty CDN Bond ETF
XST.TO	Ishares S&P TSX Capped Cons Stpl ETF
XSTB.TO	Ishares ESG CDN ST Bond Index ETF
XSU.TO	Ishares US Small Cap Index ETF
XSUS.TO	Ishares ESG MSCI USA Index ETF
XTC.TO	Exco Tech
XTD.TO	Tdb Split Corp Class A Shares
XTD.PR.A.TO	Tdb Split Corp Priority Equity Shares
XTG.TO	Xtra Gold Resources Corp
XTR.TO	Ishares Diversified Monthly Income ETF
XUH.TO	Ishares Core S&P US Total Mkt ETF CAD Heg
XUS.TO	Ishares Core S&P 500 Index ETF
XUS.U.TO	Ishares Core SP 500 Index ETF
XUSR.TO	Ishares ESG Advanced MSCI USA Index ETF
XUT.TO	Ishares S&P TSX Capped Utilities ETF
XUU.TO	Ishares Core S&P US Total Market ETF
XUU.U.TO	Ishares Core SP US Total Market ETF USD
XVLU.TO	Ishares Edge MSCI USA Value Fctr ETF
XWD.TO	Ishares MSCI World Index ETF
XXM.TO	CI First Asset Morningstar US Value Index ETF
XXM.B.TO	CI First Asset Morningstr US Value Idx Unhdgd Et
Y.TO	Yellow Pages Limited
Y.WT.TO	Yellow Pages Limited WT
YCM.TO	Commerce Split Corp Capital Shares
YCM.PR.A.TO	Commerce Split Corp Class I Pref Shares
YCM.PR.B.TO	Commerce Split Corp Class II Pref Shares
YGR.TO	Yangarra Resources Ltd
YPG.DB.TO	Yp Digital and Media Sol 8 Pct Debs
YRB.TO	Yorbeau Resources Inc
YRI.TO	Yamana Gold Inc
YXM.TO	CI First Asset Morningstar US Momentum Index ETF
YXM.B.TO	CI First Asset Morningstar US Momentum Unhdgd Et
ZAG.TO	BMO Aggregate Bond Index ETF
ZBAL.TO	BMO Balanced ETF
ZBBB.TO	BMO BBB Corporate Bond Index ETF
ZBK.TO	BMO Equal Weight US Bank ETF
ZCB.TO	BMO Corporate Bond Index ETF
ZCH.TO	BMO China Equity Index ETF
ZCM.TO	BMO Mid Corporate Bond ETF
ZCN.TO	BMO S&P TSX Capped Comp ETF
ZCON.TO	BMO Conservative ETF
ZCPB.TO	BMO Core Plus Bond Fund
ZCS.TO	BMO Short Corp Bond ETF
ZCS.L.TO	BMO Short Corporate Bond ETF
ZDB.TO	BMO Discount Bond ETF
ZDH.TO	BMO Intl Div CAD Hedge ETF
ZDI.TO	BMO International Dividend ETF
ZDJ.TO	BMO DJIA Hedged To CAD Index ETF
ZDM.TO	BMO MSCI EAFE Hedged To CAD Index ETF
ZDV.TO	BMO Canadian Dividend ETF
ZDY.TO	BMO US Dividend ETF CAD
ZDY.U.TO	BMO US Dividend ETF USD
ZEA.TO	BMO MSCI EAFE ETF
ZEB.TO	BMO S&P TSX Equal Weight Banks Index ETF
ZEF.TO	BMO Emg Mkt Bond Hdgd To CAD ETF
ZEM.TO	BMO MSCI Emerging Markets Index ETF
ZENA.TO	Zenabis Global Inc
ZENA.WT.TO	Zenabis Global Inc WT
ZEO.TO	BMO S&P TSX Eql Weight Oil Gas Index ETF
ZEQ.TO	BMO MSCI EU Hq Hcad ETF
ZESG.TO	BMO Balanced ESG ETF
ZFC.TO	BMO Sia Focused Canadian Equity Fund
ZFH.TO	BMO Floating Rate High Yield ETF
ZFL.TO	BMO Long Fed Bond Index ETF
ZFM.TO	BMO Mid Federal Bond Index ETF
ZFN.TO	BMO Sia Focused North American Equity Fu
ZFS.TO	BMO Short Federal Bond Index ETF
ZFS.L.TO	BMO Short Federal Bond Index ETF
ZGB.TO	BMO Government Bond Index ETF
ZGD.TO	BMO S&P TSX Eql Weight Global Gold ETF
ZGI.TO	BMO Global Infrastructure Index ETF
ZGQ.TO	BMO MSCI All Cntry Wrld High Qlty ETF
ZGRO.TO	BMO Growth ETF
ZGSB.TO	BMO Global Strategic Bond Fund
ZHP.TO	BMO US Pref Share Hgd To CAD ETF
ZHU.TO	BMO Equal Weight US Health Care Idx ETF
ZHY.TO	BMO High Yld US Corp Bnd Hdg CAD ETF
ZIC.TO	BMO Mid Term US IG Corp Bond ETF
ZIC.U.TO	BMO Mid Term US IG Corp Bond ETF USD
ZID.TO	BMO India Equity Index ETF
ZIN.TO	BMO S&P TSX Equal Weight Indstrl ETF
ZJG.TO	BMO Junior Gold Index ETF
ZJK.TO	BMO High Yield US Corp Bond ETF
ZJN.TO	BMO Junior Gas Index ETF
ZJO.TO	BMO Junior Oil Index ETF
ZLB.TO	BMO Low Volatility CAD Equity ETF
ZLC.TO	BMO Long Corporate Bond Index ETF
ZLD.TO	BMO Low Vol Intl Eqty Hed To CAD ETF
ZLE.TO	BMO Low Vol Emerg Mkt Equity ETF
ZLH.TO	BMO Low Vol US Eqty Hed To CAD ETF
ZLI.TO	BMO Low Vol Intl Equity ETF
ZLU.TO	BMO Low Volatility US Equity ETF CAD
ZLU.U.TO	BMO Low Volatility US Equity ETF USD
ZMBS.TO	BMO Canadian MBS Index ETF
ZMI.TO	BMO Monthly Income ETF
ZMID.TO	BMO SP US Mid Cap Index ETF
ZMID.U.TO	BMO SP US Mid Cap Index ETF USD
ZMP.TO	BMO Mid Provincial Bond Index ETF
ZMSB.TO	BMO Global Multi Sector Bond Fund
ZMT.TO	BMO Sptsx Eql Wgt Glb Metal Hed CAD ETF
ZMU.TO	BMO Mid Term US IG Corp Bd Hgd CAD Idx
ZNQ.TO	BMO Nasdaq 100 Equity Index ETF
ZPAY.TO	BMO Premium Yield ETF
ZPAY.F.TO	BMO Premium Yield ETF Hedged
ZPAY.U.TO	BMO Premium Yield ETF USD
ZPH.TO	BMO US Put Write Hedged To CAD ETF
ZPL.TO	BMO Long Provincial Bond Index ETF
ZPR.TO	BMO Laddered Pref Share ETF
ZPS.TO	BMO Short Provincial Bond Index ETF
ZPS.L.TO	BMO Short Provincial Bond Index ETF
ZPW.TO	BMO US Put Write ETF
ZPW.U.TO	BMO US Put Write ETF USD
ZQB.TO	BMO High Quality Corporate Bond Idx ETF
ZQQ.TO	BMO Nasdaq 100 Hedged To CAD Index ETF
ZRE.TO	BMO Equal Weight Reits Index ETF
ZRR.TO	BMO Real Return Bond Index ETF
ZSB.TO	BMO Short Term Bond Idx ETF
ZSML.TO	BMO SP US Small Cap Index ETF
ZSML.F.TO	BMO SP US Small Cap Index ETF Hedged
ZSML.U.TO	BMO SP US Small Cap Index ETF USD
ZSP.TO	BMO S&P 500 Index ETF
ZSP.U.TO	BMO S&P 500 Index ETF USD
ZST.TO	BMO Ultra Short Term Bond ETF
ZST.L.TO	BMO Ultra Short Term Bond ETF
ZSU.TO	BMO ST US IG Corp Bond Hcad ETF
ZUB.TO	BMO Eql Wgt US Bank Hdgd To CAD ETF
ZUD.TO	BMO US Dividend Hedged To CAD ETF
ZUE.TO	BMO S&P 500 Hedged CAD ETF
ZUH.TO	BMO Eql Wgt US Hcare Hdgd To CAD ETF
ZUP.TO	BMO US Pref Share Index ETF
ZUP.U.TO	BMO US Pref Share Index ETF
ZUQ.TO	BMO MSCI USA High Quality Index ETF
ZUQ.F.TO	BMO MSCI USA High Quality Index ETF [Hed
ZUQ.U.TO	BMO MSCI USA High Quality Index ETF USD
ZUS.U.TO	BMO Ultra Short Term US Bond ETF USD
ZUS.V.TO	BMO Ultra Short Term US Bond ETF USD Acc
ZUT.TO	BMO Equal Weight Utilities Index ETF
ZVC.TO	BMO MSCI Cda Value Index ETF
ZVI.TO	BMO MSCI EAFE Value Index ETF
ZVU.TO	BMO MSCI USA Value Index ETF
ZWA.TO	BMO Covered Call DJIA CAD ETF
ZWB.TO	BMO Covered Call Canadian Banks ETF
ZWC.TO	BMO CDN High Div Covered Call ETF
ZWE.TO	BMO Europe High Div CC CAD Hedge ETF
ZWG.TO	BMO Gbl High Dividend Covered Call ETF
ZWH.TO	BMO US High Dividend Covered Call ETF
ZWH.U.TO	BMO US High Dividend Cov Call ETF USD
ZWK.TO	BMO Covered Call US Banks ETF
ZWP.TO	BMO Europe High Div Cov Call ETF
ZWS.TO	BMO US High Div Cov Call Hgd ETF
ZWU.TO	BMO Covered Call Utilities ETF
ZXM.TO	CI First Asset Morningstar Intl Momentum ETF
ZXM.B.TO	CI First Asset Morningstar Intl Momentum ETF
ZZZ.TO	Sleep Country Canada Holdings Inc
ZZZD.TO	BMO Tactical Dividend ETF Fund
